number of rooms,security level of the community,residence space,noise level,view,aboveground space ,basement space,building year,total cost
5,2.5,2820,2.0,0,2820,0,1979,675000.0001
2,1.0,1210,1.0,0,1210,0,1949,235000.0
4,2.5,2200,2.0,0,2200,0,1987,237227.8571
3,1.5,1200,1.0,0,1200,0,1965,242499.9999
3,1.75,1370,1.0,0,1370,0,1987,257950.0
4,2.0,1480,1.0,0,1480,0,1974,260000.0
3,1.5,1180,1.0,0,1180,0,1983,275000.0
3,2.5,2090,1.0,0,1360,730,1987,285000.0
3,3.0,1850,1.0,0,1090,760,1992,287200.0
2,2.5,1630,2.0,0,1280,350,2009,295000.0
3,2.5,2540,2.0,0,2540,0,2006,300000.0
2,1.0,850,1.0,0,850,0,1950,308500.0
3,1.0,1160,1.0,0,1160,0,1968,315000.0
3,2.25,1580,1.0,0,1580,0,1978,335000.0001
2,2.0,1350,1.0,0,1350,0,1976,335000.0
3,2.0,1930,1.0,0,1930,0,1966,342000.0001
3,1.0,1090,1.0,0,1090,0,1955,365000.0
4,3.0,3110,2.0,0,3110,0,1997,367500.0
4,1.75,1560,1.0,0,1560,0,1967,382500.0001
3,3.25,1320,2.0,0,1040,280,2008,385000.0
3,2.0,1960,1.0,2,1650,310,1957,403000.0
3,2.5,1930,2.0,0,1930,0,1996,407500.0001
3,1.5,1570,1.0,0,1570,0,1956,419000.0
3,2.25,2000,1.0,0,1000,1000,1963,420000.0
4,1.5,1920,1.0,0,1070,850,1954,430000.0
4,1.0,1450,1.0,0,1450,0,1954,435000.0
3,2.5,1770,3.0,0,1600,170,2007,436110.0
3,2.25,1970,2.0,0,1970,0,1977,437500.0001
3,2.5,1770,2.0,0,1770,0,1990,439950.0
4,2.25,2160,1.0,0,1080,1080,1966,439999.9999
3,2.5,1270,3.0,0,1270,0,2001,445700.0
3,2.5,2680,2.0,0,2680,0,2013,459990.0
3,1.75,1710,1.0,0,1710,0,1948,463000.0
5,2.5,2210,1.0,0,1460,750,1976,470000.0
4,2.5,2710,2.0,0,2710,0,1989,482000.0001
4,1.75,2190,1.0,2,2190,0,1968,491500.0
4,1.75,1600,1.0,0,1130,470,1959,495000.0
4,2.5,2860,2.0,0,2190,670,2004,499949.9999
3,1.75,2910,1.5,0,2910,0,1979,550000.0001
4,2.5,1940,1.0,0,1140,800,1976,550000.0
4,2.5,3310,2.0,0,3310,0,2012,554999.9999
3,1.75,2330,1.0,0,1970,360,1980,588500.0
3,2.5,3240,2.0,2,3240,0,1995,603999.9999
4,2.5,2730,2.0,0,2730,0,1991,612499.9999
3,1.75,2360,1.0,0,1360,1000,1948,615000.0
4,3.25,2730,1.0,0,1560,1170,2007,624999.9998
4,2.5,2820,2.0,0,2820,0,2014,625000.0
3,2.25,1750,2.5,0,1470,280,2005,626000.0001
4,2.75,2710,2.0,0,2710,0,2000,630000.0001
4,2.0,1520,1.5,0,1520,0,1945,640000.0
4,2.0,1820,1.5,1,1640,180,1945,650000.0
4,2.25,2200,1.5,0,1300,900,1920,697999.9999
3,2.5,2390,1.0,2,1440,950,1955,750000.0
3,1.75,2240,2.0,0,1550,690,1923,750000.0
5,3.25,3660,2.0,2,3660,0,2006,785000.0001
3,2.5,2600,1.0,0,1700,900,1951,789999.9999
3,2.0,2710,1.5,0,1880,830,1929,805000.0
4,2.5,3310,2.0,0,3310,0,2001,838000.0002
5,2.75,2910,1.5,0,2910,0,1939,1200000.0
3,1.0,1010,1.0,0,1010,0,1973,310000.0
3,2.5,1650,1.0,0,1130,520,1986,379880.0
4,2.75,2920,2.0,0,2920,0,2012,624999.9999
4,2.5,2530,2.0,2,2010,520,1990,331949.9999
3,2.5,2200,1.0,0,1570,630,1988,365000.0
4,2.0,2280,1.0,0,1140,1140,1900,628000.0
2,2.5,2680,1.0,0,2680,0,2004,775000.0
3,2.5,2850,2.0,0,1990,860,1980,783499.9999
2,1.0,810,1.0,0,810,0,1944,206000.0
4,1.5,1240,1.0,0,1240,0,1971,220000.0
2,1.0,1200,1.0,0,1200,0,1958,232000.0
3,1.75,1920,1.0,0,1000,920,1984,245000.0
3,2.0,1550,1.0,0,1550,0,1958,249949.9999
3,1.0,1450,1.0,0,1450,0,1953,287000.0
3,2.0,1050,1.0,0,1050,0,1986,300000.0
4,2.75,2310,2.0,0,2310,0,2006,309950.0001
3,2.5,1880,2.0,0,1880,0,1994,309950.0
4,2.5,2370,2.0,0,2370,0,1998,327999.9999
2,1.0,1140,1.5,0,1140,0,1949,329950.0
5,1.0,1120,1.5,0,1120,0,1962,340000.0
2,1.5,1160,2.0,0,1160,0,2001,340000.0
3,3.0,1571,3.0,0,1571,0,2008,366750.0
4,1.75,1970,1.0,0,1140,830,1960,379950.0
5,2.5,3090,1.0,0,1750,1340,1968,384899.9999
3,2.5,2230,2.0,0,2230,0,1954,398750.0
2,1.75,2110,1.0,0,2110,0,1948,400000.0001
2,1.0,840,1.0,0,840,0,1955,400000.0
2,3.0,1410,2.0,0,1140,270,2006,405000.0
3,2.25,1410,3.0,0,1410,0,2005,406100.0
3,2.25,1800,1.0,0,1360,440,1978,409999.9999
3,2.25,1620,2.5,0,1540,80,2010,414999.9999
3,2.5,1408,3.0,0,1408,0,2005,416286.0
3,2.0,1410,1.5,0,1410,0,1930,418000.0
2,2.5,1590,2.0,0,1590,0,2014,419190.0
5,2.0,1840,1.0,0,1540,300,1942,435000.0
4,2.0,1480,1.5,0,1480,0,1928,449250.0
3,2.5,3040,2.0,0,3040,0,2007,478000.0
4,3.0,2340,1.0,0,1340,1000,1979,484999.9999
4,1.75,2010,1.0,0,1470,540,1977,487585.0
4,2.5,2910,2.0,0,2910,0,2006,499000.0
4,1.0,2070,1.0,0,1160,910,1963,501000.0
3,2.5,1790,2.0,0,1790,0,2010,509900.0
3,1.75,1560,1.0,0,780,780,1944,524000.0
5,2.75,2740,1.0,0,1370,1370,1960,541125.0
4,2.5,2910,2.0,0,2910,0,2008,549000.0001
3,2.5,1940,2.0,0,1940,0,2009,554999.9999
3,2.5,1900,2.0,0,1900,0,1987,559999.9999
3,2.25,2010,1.0,0,1330,680,1975,569999.9999
2,1.0,2540,1.0,0,1320,1220,1942,580000.0
2,1.0,1770,1.5,0,1520,250,1949,584999.9999
3,1.75,1670,1.0,0,1670,0,1976,600000.0001
3,1.75,1880,1.0,0,1040,840,1945,600000.0
4,1.75,2300,1.0,0,1960,340,1977,615000.0
3,2.0,1800,1.0,0,1080,720,1942,618499.9999
4,2.25,1990,1.0,0,1210,780,1973,626999.9999
4,2.5,2440,2.0,0,2440,0,2014,631625.0001
3,1.5,2160,1.0,2,1400,760,1949,650000.0
3,2.5,1680,3.0,0,1680,0,1909,669999.9999
3,2.5,2490,2.0,0,2490,0,2003,705380.0
4,2.5,2450,2.0,0,2450,0,2013,712198.0
4,2.5,3180,2.0,3,3180,0,2000,736500.0
4,2.5,2800,1.0,0,1660,1140,1963,744312.4999
4,2.5,2120,1.0,0,1620,500,1960,754999.9999
3,2.0,2350,1.5,0,1810,540,1939,770000.0
4,2.5,2730,2.0,2,2730,0,1996,780000.0
3,2.5,3240,2.0,0,3240,0,1994,800000.0001
5,2.5,3180,2.0,0,3180,0,1990,800865.9999
6,1.75,2920,2.5,0,2780,140,1908,822999.9999
4,2.5,3400,2.0,0,3400,0,2007,829999.9999
4,3.0,2170,2.0,0,1610,560,1982,831000.0
4,3.0,3690,2.0,0,3690,0,1998,865000.0001
4,4.25,4420,2.0,0,3410,1010,2006,890000.0001
5,3.5,4490,2.0,0,3200,1290,2006,890000.0
5,2.75,3190,1.0,3,1690,1500,1976,1030000.0
5,3.5,4010,2.0,1,2850,1160,1971,1395000.0
7,8.0,13540,3.0,4,9410,4130,1999,2279999.999
3,1.5,1420,1.0,0,1420,0,1962,136500.0001
3,1.0,1010,1.0,0,1010,0,1954,175000.0
3,1.5,800,1.0,0,800,0,1959,191000.0
3,1.75,1690,1.0,0,1060,630,1976,197000.0
3,1.75,1850,1.0,0,1320,530,1979,218000.0
2,1.0,900,1.0,0,900,0,1952,219000.0
3,1.75,1490,1.0,0,1010,480,1975,234000.0
3,1.0,1050,1.0,0,1050,0,1954,250000.0
3,2.5,1650,2.0,0,1650,0,1998,272000.0001
3,1.75,1580,1.0,1,1100,480,1962,279900.0
3,2.25,1970,1.0,0,1180,790,1967,280000.0
3,1.75,1630,1.0,0,1630,0,1971,280000.0
4,2.5,2000,2.0,0,2000,0,2003,284000.0
3,2.25,1980,1.0,0,1560,420,1974,295000.0
4,2.0,1300,1.0,0,1300,0,1950,312000.0
3,1.0,1510,1.0,0,860,650,1940,313950.0
4,2.5,1890,1.0,0,980,910,1980,324999.9999
2,1.0,720,1.0,0,720,0,1942,329350.0
4,2.5,2331,2.0,0,2331,0,2007,345000.0
3,1.0,1110,1.0,0,1110,0,1956,345000.0
3,1.0,1350,1.0,0,860,490,1947,353000.0
4,2.0,2680,1.0,0,2680,0,1965,360000.0
3,2.25,1640,1.0,0,1140,500,1963,362000.0
3,1.5,1310,1.0,0,1310,0,1950,365000.0
3,1.5,1410,1.0,0,1410,0,1961,367500.0001
3,2.0,1270,3.0,0,1270,0,2006,369950.0
4,1.75,1500,1.0,0,1000,500,1955,379900.0
3,1.75,1900,1.0,0,1280,620,1982,385000.0
3,1.0,1230,1.0,0,1230,0,1962,386999.9999
5,3.75,2890,1.0,0,1310,1580,2006,389999.9999
3,1.75,1260,1.0,0,1260,0,1966,390000.0001
4,2.0,1440,1.0,0,1200,240,1971,397000.0
4,1.75,1840,1.0,0,960,880,1958,404000.0
4,2.0,1520,1.0,0,1520,0,1967,425000.0
3,3.5,3020,2.0,0,2080,940,1954,439333.3333
5,2.5,2240,1.0,0,1340,900,1978,455000.0
6,3.0,3470,1.5,0,3470,0,1924,474999.9997
4,2.5,2740,2.0,0,2740,0,1995,483499.9998
2,1.75,1660,1.0,0,1160,500,1942,484000.0
3,2.0,1420,1.5,0,1420,0,1905,485000.0
5,2.0,2020,1.5,0,2020,0,1938,488000.0
2,1.75,1170,1.0,0,740,430,1903,499000.0
3,2.5,1480,3.0,0,1480,0,2006,500000.0
4,2.5,2000,2.0,0,2000,0,1996,513000.0
3,2.5,1790,2.0,0,1790,0,1989,515000.0001
3,1.5,1430,1.0,0,1430,0,1956,518000.0
3,2.5,2460,2.0,0,2460,0,1980,519999.9999
3,2.5,2970,1.0,0,1770,1200,1995,524999.9999
5,2.5,2910,1.0,0,1690,1220,1964,530000.0
5,2.75,1800,1.5,0,1400,400,1926,533000.0
3,2.5,1850,2.0,0,1850,0,1991,534999.9999
3,2.0,2000,2.0,0,2000,0,1916,561000.0
5,2.25,3040,2.0,0,3040,0,1984,562000.0001
4,3.0,3100,2.0,0,2400,700,1996,563000.0001
3,1.75,2130,1.0,2,1170,960,1954,575000.0001
4,3.25,3569,2.0,0,3569,0,2013,580000.0001
4,2.25,2260,2.0,0,1400,860,1977,599000.0001
4,2.5,2110,2.0,0,2110,0,1987,606000.0
4,2.5,2150,2.0,0,2150,0,1985,609000.0
4,3.0,2450,1.0,0,1580,870,1967,610000.0
4,2.0,2060,1.0,0,1030,1030,1949,612499.9999
3,1.5,1630,1.0,1,1160,470,1940,650000.0
4,3.5,3380,2.0,0,3380,0,2000,655499.9999
4,2.5,3030,2.0,0,3030,0,1999,685000.0
4,2.5,3200,2.0,0,3200,0,1998,725126.0
4,2.5,2290,2.0,0,2290,0,1988,736000.0001
4,2.5,3880,2.0,0,3880,0,1987,762300.0002
4,2.5,3040,2.0,0,3040,0,2008,776000.0001
4,2.0,3740,2.0,0,3740,0,2000,860000.0
3,2.5,2690,3.0,0,2690,0,2014,979000.0001
4,2.75,3370,1.0,3,1970,1400,1970,1135000.0
4,2.25,3490,2.0,0,2280,1210,1928,1225000.0
4,3.25,3760,1.5,0,2400,1360,1950,1580000.0
5,4.0,4510,2.0,0,4510,0,1969,1870000.0
2,1.0,1040,1.0,0,1040,0,1912,160000.0
3,2.0,1570,1.0,0,1570,0,1952,176225.0
4,1.0,1490,1.0,0,1490,0,1969,185000.0
3,1.5,1380,1.0,0,1380,0,1960,209950.0001
3,1.75,1640,1.0,0,1130,510,1988,226500.0
3,2.5,1920,2.0,0,1920,0,1988,230000.0001
3,2.0,1410,1.0,0,1410,0,1985,239900.0
3,1.5,1260,2.0,0,1040,220,2005,245000.0
3,1.0,1400,1.0,0,1400,0,1944,246000.0
4,1.75,1720,1.0,0,1720,0,1960,248499.9999
3,1.0,1110,1.0,0,1110,0,1952,249000.0
1,1.0,1100,1.0,0,820,280,1947,250000.0
3,1.75,1250,1.0,0,1250,0,1994,253000.0
5,2.25,2060,1.0,0,1030,1030,1962,255000.0
3,2.5,1600,2.0,0,1600,0,1993,275000.0
3,2.5,1600,2.0,0,1600,0,2000,280000.0
3,1.75,1840,1.0,0,1220,620,1974,310000.0
3,1.75,2190,1.0,0,2190,0,1967,313000.0
3,1.75,1870,1.0,0,1870,0,1957,314500.0
3,1.0,1040,1.0,0,1040,0,1968,314949.9999
3,3.0,1680,3.0,0,1680,0,2014,330000.0
3,2.25,1630,2.0,0,1630,0,1985,339950.0
3,1.0,1010,1.0,0,1010,0,1981,350000.0
5,2.5,2420,1.0,2,1620,800,1978,352000.0
2,1.0,820,1.0,0,820,0,1944,361280.0
5,2.75,2410,1.0,0,1410,1000,2008,365000.0
3,2.5,1830,2.0,0,1830,0,1990,374999.9999
2,1.0,1640,1.0,0,840,800,1978,379499.9999
5,1.75,3000,1.0,0,1500,1500,1958,380000.0
3,2.25,1660,1.0,0,1660,0,1961,405000.0
4,2.75,2140,1.0,0,1320,820,1968,409500.0
4,3.0,1830,2.0,0,1830,0,1991,415000.0
3,2.25,1606,3.0,0,1606,0,2009,417249.9999
3,2.25,1770,2.0,0,1770,0,1977,420000.0
2,2.5,1150,3.0,0,1150,0,2008,425000.0
2,2.0,1350,1.0,0,1350,0,2003,428000.0
3,1.75,1500,1.0,0,1060,440,1947,440000.0001
3,2.5,1600,2.0,0,1600,0,2013,444845.0
3,2.0,1760,2.0,0,1760,0,1985,460000.0
4,2.5,2180,1.0,0,2180,0,1968,480500.0001
3,2.0,1610,1.0,0,1010,600,1917,485000.0
4,2.5,3305,1.5,0,2245,1060,1922,492000.0
4,2.75,2656,2.0,0,2656,0,2014,495000.0
3,2.5,1940,1.0,0,1940,0,1987,499999.9998
3,2.5,2280,2.0,0,1880,400,2006,500324.0001
3,2.75,1540,1.0,0,1210,330,1980,502999.9999
4,2.5,2430,2.0,0,2430,0,2003,510000.0
3,1.75,1580,1.0,1,1210,370,1967,515000.0
3,2.25,1170,3.0,0,1170,0,2014,519950.0
2,2.0,1550,1.5,0,1550,0,1900,526000.0
3,1.0,1340,1.0,0,1080,260,1910,530000.0
7,5.75,3700,2.0,1,3700,0,1948,540000.0
3,3.0,4120,2.0,2,3180,940,1994,560000.0001
3,2.0,1860,1.0,0,1860,0,1985,559999.9999
3,2.0,2350,1.5,0,1780,570,1929,568000.0
4,2.0,1650,1.0,0,1650,0,1955,575000.0001
4,2.0,2510,1.0,0,1280,1230,1961,581000.0
3,1.75,1960,1.0,0,1090,870,1920,599000.0
9,4.5,3830,2.5,0,2450,1380,1938,599999.0
3,2.5,2460,1.0,0,1860,600,1977,600000.0003
3,2.5,2030,2.0,0,2030,0,1988,618080.0
2,2.25,2550,1.0,0,1720,830,2011,630000.0
3,3.0,2270,2.0,0,2130,140,2002,640000.0
3,2.5,3240,2.0,0,3240,0,1991,651000.0004
4,2.5,2650,1.5,0,1520,1130,1905,705000.0001
4,2.75,2600,2.0,0,1960,640,1949,749950.0
3,2.75,2520,1.0,0,1360,1160,1946,750000.0001
4,2.75,2410,1.0,0,1780,630,1956,758000.0
3,2.0,2540,1.5,3,1600,940,1905,774999.9999
4,2.0,2210,1.0,1,1210,1000,1954,794154.0
5,3.75,4130,2.0,0,3170,960,1985,899999.9991
4,3.5,3900,2.0,0,3900,0,2006,1040000.0
4,4.0,4460,2.0,0,4460,0,2001,1150000.0
6,2.5,3560,2.5,0,3560,0,1914,1500000.0
5,4.5,4270,2.0,0,3400,870,2007,1532500.0
2,1.5,980,2.0,0,980,0,1922,134000.0
2,1.0,720,1.0,0,720,0,1955,205000.0
3,1.0,1490,1.0,0,1490,0,1954,207000.0
4,1.75,2000,1.0,0,1100,900,1965,228000.0001
3,2.5,1190,2.0,0,1190,0,2002,229000.0
3,1.0,1390,1.0,0,1390,0,1960,230000.0
3,1.75,950,1.0,0,790,160,1939,230000.0
2,1.0,1270,1.0,0,650,620,1923,235000.0
3,1.5,1260,1.0,0,1260,0,1955,245000.0
3,1.75,1390,1.0,0,1390,0,1975,246000.0
4,1.75,1730,1.0,0,1230,500,1977,258000.0
4,1.5,2130,1.0,0,1100,1030,1962,260000.0001
4,2.5,2020,2.0,0,2020,0,2002,262000.0
3,2.5,1940,1.0,0,1460,480,1989,266000.0
4,2.5,1810,2.0,0,1810,0,1994,270000.0
3,1.75,1890,1.0,0,1890,0,1966,292285.7143
3,2.5,1920,2.0,0,1920,0,1993,295000.0
3,2.0,1240,1.0,0,1240,0,1967,297950.0
2,1.25,860,2.0,0,860,0,2007,321950.0
4,2.5,2320,2.0,0,2320,0,2004,325900.0
4,2.5,2460,2.0,0,2460,0,1989,347500.0
3,1.75,1590,1.0,0,1590,0,1988,349000.0
4,1.75,2250,1.0,0,2150,100,1940,350000.0
2,1.5,960,2.0,0,960,0,1993,358000.0
6,2.25,3206,2.0,0,3206,0,2012,375000.0001
3,1.75,1890,1.0,0,1230,660,1944,384999.9999
3,2.5,1960,1.0,0,1290,670,1977,401999.9999
3,2.75,2090,2.0,0,2090,0,2012,402999.9999
2,1.0,1020,1.0,0,1020,0,1948,404999.9999
3,2.5,1540,3.0,0,1470,70,2008,413450.0
3,1.75,1460,1.0,0,1460,0,1979,424500.0
3,1.75,1310,1.0,0,1310,0,1976,437000.0
2,1.5,1020,3.0,0,1020,0,2008,441750.0
3,2.0,1510,1.0,0,1510,0,1954,450000.0001
5,2.25,2440,1.5,0,2440,0,1975,489990.0
3,2.5,2310,2.0,0,2310,0,2011,494000.0
3,1.75,1410,3.0,0,1410,0,2012,500000.0
4,2.75,2280,1.5,0,1540,740,1930,530000.0
3,1.75,1980,1.0,0,1980,0,1973,530000.0001
3,1.0,1670,1.0,0,1170,500,1967,533000.0
4,2.5,2280,2.0,0,2280,0,2004,535000.0002
4,3.0,2920,1.0,3,1460,1460,1964,537499.9999
4,2.5,2550,2.0,0,2550,0,2005,537500.0
4,1.75,1840,1.0,0,1220,620,1967,538000.0
6,2.25,2820,1.5,2,1970,850,1940,543200.0
2,2.0,1870,1.0,0,1870,0,2006,559950.0
4,2.25,2250,2.0,0,2250,0,1980,569000.0
2,3.0,3160,2.0,0,3160,0,1993,589899.9998
3,2.5,1750,2.0,0,1750,0,1991,595000.0
2,1.0,1540,1.0,0,820,720,1946,615000.0
4,1.75,2060,1.0,0,1160,900,1947,647500.0
4,2.5,3290,2.0,0,3290,0,2002,716499.9999
3,2.5,1690,1.5,1,1690,0,1928,719000.0
4,2.5,2660,2.0,2,2660,0,2003,753888.0001
4,1.75,2480,1.0,0,1390,1090,1950,780000.0
5,3.0,3040,1.0,0,1970,1070,1968,830000.0001
3,2.5,2920,3.0,0,2920,0,2008,868500.0001
3,3.25,2640,2.0,0,1840,800,1912,930000.0
5,2.5,3160,1.0,0,1780,1380,1971,980000.0001
4,1.0,3410,2.0,0,2190,1220,1910,1039000.0
4,3.25,3820,2.0,1,3310,510,1990,1250000.0
2,1.0,720,1.0,0,720,0,1950,195000.0
3,1.0,1160,1.0,0,1160,0,1959,201500.0
2,1.5,1020,2.0,0,1020,0,2004,212000.0
4,1.0,1430,1.5,0,1430,0,1983,224500.0
3,2.5,2000,2.0,0,2000,0,1992,225000.0
3,1.0,1360,1.0,0,1360,0,1977,234950.0001
4,3.0,2163,2.0,0,2163,0,2006,247999.9999
3,1.75,1220,1.0,0,1220,0,1962,251000.0
3,1.0,1030,1.0,0,880,150,1947,252500.0
3,2.5,1850,2.0,0,1850,0,2003,254000.0
2,1.0,960,1.0,0,960,0,1984,255000.0
2,1.0,810,1.0,0,810,0,1928,255000.0
3,2.0,1920,1.0,0,1510,410,1969,260000.0
3,2.5,1420,1.0,0,1020,400,1963,260000.0
3,2.0,1690,1.0,0,1690,0,1969,270000.0
3,1.5,1500,1.0,0,1500,0,1953,270000.0
4,2.0,2190,1.0,0,1180,1010,1977,280000.0
3,1.75,1390,1.0,3,840,550,1912,280950.0
4,2.5,2000,1.0,0,1200,800,1968,290000.0
3,1.5,1060,1.0,0,1060,0,1973,303500.0
4,2.25,2130,1.0,0,1380,750,1977,311100.0001
4,2.25,1930,1.0,0,1430,500,1984,312000.0
5,1.75,2320,1.0,0,1160,1160,1956,315000.0
4,2.25,2310,2.0,0,2310,0,1980,320000.0
4,2.75,1970,1.0,0,1170,800,1977,323000.0
3,2.25,998,2.0,0,798,200,2007,324000.0
3,2.25,1352,3.0,0,1352,0,2007,325000.0001
4,2.5,1940,2.0,0,1940,0,2003,330000.0
3,1.0,1620,1.5,0,1620,0,1911,346750.0001
3,2.25,1640,1.0,0,1640,0,1972,352000.0
3,2.0,1340,3.0,0,1340,0,2008,376000.0
3,3.25,1410,3.0,0,1410,0,2005,382000.0
3,2.25,1445,2.0,0,1300,145,2003,387000.0
4,2.5,2600,2.0,0,2600,0,1988,402500.0
4,2.25,3060,2.0,0,3060,0,1992,414999.9999
4,2.0,1650,1.0,0,1000,650,1959,445000.0
2,2.0,1150,1.0,0,860,290,1940,444999.9999
4,1.75,1750,1.5,0,1050,700,1926,460000.0
2,1.0,1150,1.0,0,1150,0,1905,463000.0
4,2.5,1930,1.0,0,1930,0,1968,464999.9999
3,2.0,1410,1.0,0,1410,0,1940,481450.0
2,1.0,1840,1.5,0,1130,710,1910,489999.9999
3,1.75,1750,1.0,1,1300,450,1987,491300.0
3,2.5,2100,2.0,2,2100,0,1999,505000.0
3,2.0,1400,1.0,0,1400,0,1963,511555.0
3,2.5,2030,2.0,0,2030,0,1991,525000.0
5,3.0,3480,1.0,0,2340,1140,1976,532000.0002
3,1.75,1300,1.5,0,1300,0,1925,535999.9999
4,1.75,2000,1.5,0,1450,550,1926,536500.0001
4,2.5,2330,2.0,0,2330,0,1978,542500.0002
4,2.5,2840,2.0,0,2840,0,2012,557000.0001
4,2.25,2470,2.0,0,2470,0,1984,565000.0
3,2.25,1660,1.0,0,1370,290,1980,566000.0
4,2.5,2840,2.0,0,2840,0,1998,580000.0
4,2.5,2660,2.0,0,2660,0,2001,582999.9999
4,3.25,2400,2.0,0,2400,0,1982,585000.0001
4,2.25,2430,1.0,0,2430,0,1993,590000.0001
4,2.5,2260,2.0,0,2260,0,1989,603999.9999
3,3.0,2480,1.0,0,1620,860,1976,610000.0
4,2.75,3100,2.0,0,2000,1100,1919,742500.0
4,2.75,2790,2.0,0,2790,0,1996,764999.9999
4,3.5,2730,2.0,0,2400,330,2006,769900.0
4,2.5,2830,2.0,0,1980,850,1979,782000.0
4,2.75,3780,2.0,0,3780,0,1999,833000.0
4,3.5,3810,1.0,1,2560,1250,2013,839900.0001
3,2.5,3560,2.0,0,3560,0,1987,851000.0002
4,3.0,3750,2.0,0,3750,0,1976,920000.0
4,2.25,4230,2.0,0,4230,0,1989,985000.0
3,2.25,2950,1.5,0,2950,0,2006,1020000.0
4,4.25,5860,2.0,0,4910,950,1996,1157200.0
4,2.75,3720,1.0,4,1960,1760,1962,1370000.0
5,4.5,5190,2.0,2,3390,1800,1987,1702500.0
5,6.5,7270,2.0,0,6420,850,2010,2238888.0
4,1.0,1940,1.0,0,1080,860,1962,265000.0
3,2.5,2130,2.0,0,2130,0,2003,319999.9999
3,2.5,1350,3.0,0,1270,80,2006,394950.0
5,2.75,3060,1.0,0,1600,1460,1979,549900.0
4,2.0,2520,1.0,0,1400,1120,1921,875000.0
3,2.5,1370,2.0,0,1010,360,2007,368000.0
4,2.5,2160,2.5,0,2160,0,1902,842500.0
3,1.0,970,1.0,0,970,0,1959,156000.0
3,1.5,1370,1.0,0,1370,0,1961,185000.0
2,1.0,700,1.0,0,700,0,1953,191999.9999
3,1.0,1460,1.0,0,1460,0,1969,201000.0
3,2.5,1040,2.0,0,720,320,2004,210000.0
3,1.5,1350,1.0,0,1350,0,1941,211000.0
3,1.0,990,1.0,0,990,0,1966,225000.0
1,1.0,810,1.0,0,810,0,1941,235000.0
3,1.0,1830,1.0,0,1830,0,1942,238750.0
3,1.5,1770,1.0,0,1160,610,1959,254000.0001
2,1.0,1220,1.0,0,770,450,1910,255000.0
2,1.0,1290,2.0,0,1290,0,2008,265000.0001
4,2.5,2380,2.0,0,2380,0,1997,268971.875
2,1.75,1360,1.0,0,860,500,1975,299999.9999
5,2.25,2180,2.0,0,2180,0,1986,302000.0
3,1.75,1440,1.0,0,960,480,1951,315275.0
5,3.0,2100,1.0,0,1250,850,2013,330000.0
3,2.5,1940,2.0,0,1940,0,2004,334999.9999
3,1.0,1080,1.0,0,1080,0,1955,339000.0
3,1.5,1720,1.5,0,1720,0,1952,340999.9999
2,1.0,910,1.5,0,910,0,1906,350000.0
4,2.0,1730,1.0,0,1010,720,1943,359999.9999
3,1.0,1280,1.0,0,1280,0,1968,368000.0
2,2.5,980,2.0,0,670,310,2009,369000.0
5,3.0,2480,1.0,0,1300,1180,2004,372499.9999
4,2.5,2160,2.0,0,2160,0,2010,383000.0
3,2.25,2200,2.0,0,2200,0,1987,410000.0
2,2.5,1480,3.0,0,1480,0,2009,420000.0
3,2.5,2010,2.0,0,1390,620,2014,453246.0
3,1.5,2020,1.0,0,1190,830,1956,465000.0
2,2.5,1230,2.0,0,870,360,2004,490000.0
2,2.25,1290,3.0,0,1290,0,2007,500000.0
4,2.5,2780,1.0,0,1590,1190,1978,505000.0
4,1.75,1940,1.0,0,1030,910,1922,505000.0
4,2.25,1800,1.0,0,1360,440,1980,522000.0
3,2.5,3720,2.0,0,3720,0,1982,571986.1111
4,1.75,2120,1.0,1,1190,930,1951,582000.0
4,3.0,2110,1.5,2,1640,470,1930,610000.0
2,1.75,2040,1.5,3,2040,0,1919,614999.9999
3,1.5,1620,1.0,0,1280,340,1954,620000.0
4,2.0,1770,2.0,0,1770,0,1911,630000.0
3,2.5,1570,3.0,0,1570,0,2010,635000.0
4,2.5,2550,1.0,0,1290,1260,1964,642000.0
4,2.5,3040,2.0,0,3040,0,1999,647000.0
4,3.0,2400,1.0,0,1200,1200,1964,675000.0
4,2.5,2670,2.0,0,2670,0,1989,689999.9999
4,2.5,2760,1.5,0,1680,1080,1928,734200.0
3,2.5,2620,2.0,0,2620,0,1992,746000.0001
4,2.5,2980,2.0,0,2890,90,2000,750000.0001
4,2.5,3110,2.0,0,3110,0,2004,751000.0001
3,1.75,1720,1.0,0,1720,0,1954,770000.0
4,3.25,3680,2.0,0,2840,840,2003,787999.9999
4,2.75,2600,1.5,0,1620,980,1936,839999.9999
4,1.75,2350,1.0,0,2350,0,1961,850000.0001
3,3.25,2170,1.5,0,1650,520,1928,876649.9999
4,2.5,2830,2.0,0,2830,0,1995,885000.0001
4,3.25,4700,2.0,0,3420,1280,1978,900000.0001
3,2.0,2700,1.0,0,1350,1350,1962,909999.9999
4,2.75,3300,2.0,0,3300,0,1953,927000.0
4,2.25,3290,1.5,0,3290,0,1968,947499.9999
3,2.75,2980,1.5,2,2180,800,1917,947499.9999
5,3.0,4530,1.5,0,3200,1330,2003,949999.9997
3,2.5,2920,1.0,4,1800,1120,1954,1015000.0
4,3.25,3270,2.0,0,3110,160,2014,1033888.0
4,3.75,3280,2.0,0,2320,960,2008,1050000.0
4,4.5,5420,1.0,0,3890,1530,2001,1225000.0
4,2.25,3070,1.0,3,1870,1200,1976,1225000.0
4,3.75,3490,2.0,0,3490,0,2012,1264000.0
4,3.5,3460,2.0,0,2560,900,2004,1315000.0
5,1.75,3380,1.0,0,1690,1690,1963,1346400.0
2,1.0,790,1.0,0,790,0,1973,89999.99997
2,1.0,910,1.0,0,910,0,1943,155000.0
4,1.5,1950,1.5,0,1950,0,1939,225000.0
3,1.0,1660,1.0,0,1100,560,1963,225000.0
3,1.5,1250,1.0,0,1250,0,1967,225000.0
3,1.0,1040,1.0,0,1040,0,1947,225000.0
2,0.75,650,1.0,0,650,0,1931,230000.0
3,1.0,1900,1.5,0,1900,0,1942,239950.0001
5,1.75,2020,1.0,0,1220,800,1962,245000.0001
4,2.25,2510,1.0,0,1610,900,1972,267345.0001
3,1.0,1090,1.0,0,1090,0,1973,285000.0
3,2.25,1490,1.0,0,1170,320,1987,287000.0
3,2.5,1950,2.0,0,1950,0,1990,287600.0
3,1.0,1090,1.0,0,1090,0,1981,289000.0
3,1.0,1390,1.0,0,1390,0,1968,318999.9999
3,2.0,1350,1.0,0,1350,0,1989,322500.0
3,2.5,1450,1.0,0,840,610,2007,330000.0
3,1.75,1090,1.0,0,1090,0,1968,345000.0
3,2.5,2010,2.0,0,2010,0,1977,350000.0
3,1.75,1650,1.0,0,1060,590,1951,370000.0
5,2.5,3001,2.0,0,3001,0,2006,373000.0
3,1.0,1190,1.0,0,1190,0,1953,375000.0
3,2.0,1480,1.0,2,740,740,1943,385000.0
4,1.75,2180,1.0,0,1090,1090,1956,405000.0
4,1.0,1410,1.0,0,810,600,1925,413000.0
3,1.75,1960,1.0,0,980,980,1911,415000.0
4,2.25,2140,2.0,0,2140,0,2002,435000.0001
3,2.0,1770,1.0,0,960,810,1954,449500.0
3,2.25,2450,1.0,0,2450,0,1978,450000.0001
3,2.75,1250,2.0,0,1040,210,2010,450000.0
4,2.5,3360,2.0,0,3360,0,2001,455000.0
3,2.25,2350,1.0,0,1390,960,1977,460000.0001
5,2.5,3400,1.0,0,1700,1700,1959,464000.0
4,2.5,3740,1.0,0,2260,1480,2004,475000.0
5,4.75,3830,1.0,0,2130,1700,1976,480000.0001
4,2.5,2040,2.0,0,2040,0,2012,502000.0
4,2.5,2790,2.0,0,2790,0,2009,504999.9999
3,3.5,2876,2.0,0,2360,516,2007,525000.0
5,3.0,2450,2.0,0,2450,0,1994,525000.0
3,2.5,1580,2.0,0,1010,570,2008,525000.0
3,1.75,1690,1.0,0,1690,0,1958,529999.9999
2,2.0,1680,1.0,0,1680,0,2006,530000.0
7,4.0,3440,2.0,0,3440,0,1970,549999.9999
4,2.0,2250,1.0,0,1200,1050,1956,550000.0
3,2.5,1490,3.0,0,1490,0,2004,554250.0
3,1.0,1440,2.0,0,1440,0,1910,559999.9999
3,2.0,1530,1.0,0,1530,0,1937,570000.0
3,1.75,1580,1.0,0,1180,400,1951,575000.0
5,2.0,2290,1.0,0,1190,1100,1964,580000.0
4,1.75,2090,1.0,0,1070,1020,1963,581000.0
4,2.25,2710,2.0,0,2710,0,1977,590999.9998
3,1.75,1680,1.0,0,870,810,1922,591000.0
3,1.0,1710,1.5,0,1710,0,1909,620000.0001
3,3.5,1810,2.0,0,1440,370,2009,625000.0
4,2.0,2260,1.0,0,1430,830,1958,628000.0
4,1.75,1950,1.0,0,1370,580,1969,634999.9999
3,2.5,1740,2.0,0,1740,0,1975,645000.0001
4,2.5,2210,2.0,0,2210,0,2013,650000.0
4,2.5,2740,2.0,0,2740,0,1993,651000.0
4,3.5,3400,2.0,0,3400,0,2012,660000.0
3,2.0,1940,1.5,0,1150,790,1944,665000.0
5,3.0,3410,1.0,0,1870,1540,1968,675000.0
4,2.5,3000,2.0,0,3000,0,2006,675000.0
3,2.5,2030,2.0,0,2030,0,1975,700000.0
3,3.25,3190,2.0,0,3190,0,2007,756999.9998
3,3.25,3610,2.0,0,2440,1170,2003,776999.9999
3,1.75,2340,1.0,0,2340,0,1967,780000.0001
6,3.0,2890,2.5,0,2290,600,1906,799200.0001
5,2.75,3150,2.0,0,3150,0,2013,819900.0
4,2.5,3560,1.0,2,2290,1270,1986,860000.0
4,2.5,3520,2.5,0,2650,870,2006,870000.0001
4,2.5,3490,2.0,3,3490,0,2000,974999.9999
4,3.25,4400,2.0,0,4400,0,2003,1050000.0
5,4.25,3530,2.0,0,3530,0,2001,1400000.0
5,3.25,4860,2.0,2,3820,1040,1989,1680000.0
3,1.0,1100,1.0,0,1100,0,1978,139000.0001
2,1.0,700,1.0,0,700,0,1952,155000.0
3,1.0,860,1.0,0,860,0,1963,159999.9999
2,1.0,1170,1.0,2,1170,0,1911,175000.0
2,1.0,1240,1.0,0,1240,0,1967,215000.0
3,1.75,1340,1.0,0,1340,0,1973,223000.0
4,2.0,1630,1.0,0,1050,580,1975,234000.0
4,2.5,2230,2.0,0,2230,0,2006,253000.0
3,2.0,1850,1.0,0,1150,700,1952,257200.0
3,2.0,1570,1.0,0,1570,0,1998,265000.0
3,2.5,1780,1.0,0,1400,380,1986,266000.0001
2,1.0,700,1.0,0,700,0,1949,267800.0
3,1.0,1260,1.0,0,1260,0,1946,300000.0
3,1.75,2110,2.0,0,2110,0,1966,305494.9999
3,1.5,1220,3.0,0,1220,0,2007,306000.0
3,1.0,1480,1.0,0,1480,0,1952,310000.0
3,1.0,1050,1.0,0,1050,0,1953,310000.0
4,2.5,2010,2.0,0,2010,0,1995,316000.0
3,2.5,1840,2.0,0,1840,0,2012,317000.0
3,2.5,2220,2.0,0,2220,0,1990,325000.0001
5,2.0,1700,1.0,0,1000,700,1956,337500.0001
3,1.0,1050,1.5,0,1050,0,1906,339950.0
3,2.25,1970,2.0,0,1970,0,1997,340000.0001
3,2.25,2120,2.0,0,2120,0,1984,344999.9999
5,3.0,2257,1.0,0,1363,894,2005,349950.0
3,3.5,2100,2.0,0,2100,0,1980,356000.0
4,1.75,2010,1.0,0,1340,670,1957,364000.0
3,1.0,1290,1.0,0,980,310,1951,372220.0
3,2.5,1690,2.0,0,1150,540,2014,372977.0001
4,1.75,1620,1.0,0,860,760,1947,385000.0
4,2.5,3040,2.0,0,3040,0,1999,420000.0001
3,2.75,2580,2.0,0,2580,0,2008,437000.0
3,2.5,2910,2.0,0,2910,0,1989,450000.0
3,1.0,1660,1.0,0,1060,600,1940,458000.0
4,2.5,2310,2.0,0,2310,0,1991,470000.0
4,2.5,2150,1.0,0,1420,730,1978,486000.0001
3,2.75,1850,1.5,0,1850,0,1965,489200.0
4,2.75,2270,1.0,0,1290,980,1973,497999.9999
3,2.0,2090,1.5,0,2090,0,1959,498999.9999
3,1.75,2170,1.0,0,1450,720,1986,510000.0
3,2.5,1820,2.0,0,1820,0,2005,511000.0
3,1.75,1600,1.5,0,1600,0,1924,525000.0
4,2.75,2450,1.0,0,2450,0,1974,530000.0
4,1.75,1900,1.0,0,950,950,1955,542000.0
2,2.0,2370,1.5,0,1600,770,1992,542999.9995
3,2.5,2090,1.0,0,1360,730,1962,543000.0
3,1.75,2000,1.0,0,1110,890,1921,546000.0
3,1.5,1830,1.0,0,1830,0,1957,562000.0
4,2.5,2240,2.0,0,2240,0,1989,565000.0001
5,1.75,2220,1.5,0,1420,800,1923,607500.0
5,2.5,2540,2.0,0,1760,780,1929,620000.0
4,2.75,1680,1.0,0,1680,0,1966,624999.9999
4,2.5,2470,2.0,0,2470,0,1993,633099.9999
3,1.75,1830,1.5,2,1830,0,1903,682000.0
3,1.5,2360,2.0,0,1930,430,1926,702500.0
4,3.25,3200,2.0,0,3200,0,2004,706999.9999
4,2.25,2060,1.0,0,1360,700,1941,715000.0
4,2.5,2700,2.0,0,2700,0,2004,723000.0
5,5.0,5774,1.0,2,4490,1284,1984,740000.0001
4,2.5,3430,2.0,0,3430,0,2000,740000.0
3,2.5,3030,1.5,0,3030,0,1992,766950.0
3,2.75,2470,2.0,0,2470,0,2007,773000.0
3,2.5,2580,2.0,0,2580,0,1986,802000.0
4,2.5,2190,2.5,0,2190,0,1958,924999.9999
3,2.5,3100,1.0,0,3100,0,1954,930000.0001
4,2.5,3320,2.0,0,3320,0,1995,949999.9999
5,2.25,2510,2.0,0,2510,0,1972,954999.9999
5,4.5,3810,2.0,0,3810,0,2008,965999.9999
4,2.25,4470,2.0,0,4470,0,1988,1120000.0
4,3.5,4910,1.5,0,3110,1800,2007,1222500.0
3,1.0,1040,1.0,0,1040,0,1959,148612.5
3,1.0,1060,1.0,0,1060,0,1970,174949.9999
3,1.0,1150,1.0,0,1150,0,1932,185000.0
3,1.0,1090,1.0,0,1090,0,1967,190000.0
3,1.0,980,1.5,0,980,0,1903,197500.0
4,2.0,1670,1.0,0,1670,0,1967,204700.0
3,1.0,1160,1.0,0,1160,0,1969,215000.0
3,2.0,1400,1.0,0,1150,250,1979,225000.0
3,2.0,1400,1.0,0,700,700,1948,240000.0001
3,1.75,1490,1.0,0,1490,0,1990,245000.0
3,1.0,1230,1.0,0,1230,0,1957,250000.0
3,2.0,1650,1.0,0,1160,490,1979,252350.0
4,2.5,2070,2.0,0,2070,0,1989,255000.0001
3,2.5,1690,2.0,0,1690,0,2003,256883.0
3,2.25,1590,2.0,0,1590,0,1991,263000.0
3,1.0,1010,1.0,0,1010,0,1969,270000.0
4,2.5,1840,2.0,0,1400,440,2004,274750.0001
3,1.0,1330,1.5,0,1330,0,1959,279999.9999
3,1.5,850,1.0,0,850,0,1986,295000.0
3,1.0,1220,1.0,0,1220,0,1955,300000.0001
3,2.0,1510,1.0,2,1230,280,1973,300000.0001
4,1.75,2020,1.0,0,1010,1010,1963,302000.0
3,2.25,1490,2.0,0,1220,270,2009,312000.0
2,1.0,880,1.0,0,880,0,1919,312500.0
4,2.5,2150,2.0,0,2150,0,1991,316500.0
3,1.75,1960,1.0,0,980,980,1948,340000.0
3,2.25,1180,2.0,0,1180,0,1986,342400.0
4,1.75,2290,1.0,0,1340,950,1960,343000.0
3,2.5,1232,3.0,0,1232,0,2007,344000.0
3,2.5,1700,2.0,0,1700,0,1994,349950.0
3,1.0,1400,1.0,0,1400,0,1957,349950.0
4,2.5,2710,2.0,0,2710,0,1998,370000.0001
4,1.75,1890,1.0,0,1250,640,1960,375000.0
3,2.5,1720,2.0,0,1720,0,2010,386380.0
3,2.5,2240,2.0,0,2240,0,1996,390000.0001
3,1.5,1120,1.0,0,1120,0,1955,395300.0
3,1.0,1630,1.0,0,1630,0,1953,400000.0
3,1.5,1490,1.0,0,1490,0,1963,412500.0
3,1.5,1340,1.0,0,1340,0,1956,417000.0
4,1.75,1880,1.0,0,1010,870,1976,423000.0
2,1.0,1320,1.0,1,1320,0,1912,451555.0
3,2.5,1870,1.0,0,1470,400,1980,455000.0001
3,1.75,1410,1.0,0,1410,0,1924,464999.9999
3,1.5,1260,1.0,0,1260,0,1959,465750.0
3,1.0,1660,1.0,0,1000,660,1946,467000.0
7,3.5,2870,1.0,0,1520,1350,1961,475000.0
4,2.0,2050,1.5,0,1210,840,1941,495000.0
4,2.5,2240,2.0,0,2240,0,1995,497000.0
3,2.5,1840,2.0,0,1840,0,1997,512500.0
3,2.5,2700,2.0,0,2700,0,1991,525000.0001
3,2.0,1640,1.0,0,1640,0,1977,540833.3332
3,2.25,1980,1.0,0,1980,0,1980,550000.0
4,2.5,3020,1.0,0,1600,1420,1979,574999.9999
2,1.0,1490,1.0,0,1090,400,1946,575000.0
3,2.5,2360,2.0,3,2360,0,1996,580050.0
4,2.75,2550,1.0,0,1440,1110,1986,582800.0
5,1.75,2000,2.0,0,2000,0,1921,585000.0
4,2.5,2240,1.0,0,2240,0,1983,592500.0
4,2.0,1550,1.5,0,1550,0,1909,612999.9999
4,2.5,2680,2.0,0,2680,0,1989,620000.0001
4,2.0,2560,1.0,0,1890,670,1947,640000.0001
4,3.25,2740,2.0,0,2060,680,2003,689899.9999
3,2.5,4560,2.0,0,3800,760,1986,695000.0
4,3.0,3150,2.0,0,3150,0,2001,694999.9999
4,2.5,3240,2.0,0,3240,0,1985,749399.9999
5,3.75,3580,2.0,0,3190,390,1999,764999.9999
4,2.5,3310,2.0,0,3310,0,2004,803099.9999
5,2.75,3030,2.0,0,3030,0,2013,819995.0
4,3.5,3930,2.0,1,2820,1110,2013,828950.0
4,1.75,2930,1.0,3,1670,1260,1947,840000.0001
4,2.5,3950,3.0,0,3950,0,2013,914500.0
5,4.25,3920,2.0,0,2900,1020,1990,1000000.0
4,3.25,3740,1.0,0,2000,1740,1988,1085000.0
4,2.5,3200,2.0,0,3200,0,2006,1255000.0
2,1.0,1010,1.0,0,1010,0,1955,174500.0
3,1.0,1000,1.0,0,1000,0,1940,180000.0
5,1.75,1730,1.0,0,1050,680,1978,204999.9999
3,2.0,1020,2.0,0,720,300,2004,238000.0
4,2.25,1860,1.0,0,1120,740,1979,239899.9999
5,1.0,1460,2.0,0,1460,0,1941,239950.0
2,1.0,870,1.0,0,870,0,1941,245000.0
4,3.5,1850,2.0,0,1130,720,1986,248000.0
3,2.25,1440,1.0,0,940,500,1982,249000.0
3,2.0,1900,1.0,0,950,950,1966,249999.9999
2,1.5,1070,1.0,0,1070,0,1985,252700.0
4,2.0,1510,1.0,0,1510,0,1955,254000.0
3,2.5,1480,2.0,0,1480,0,1987,275000.0
2,1.0,830,1.0,0,830,0,1954,282613.0
3,2.5,1870,2.0,0,1870,0,2005,306000.0
3,2.25,2060,1.0,0,1560,500,1978,306499.9999
4,2.5,2340,2.0,0,2340,0,2003,314000.0001
3,2.0,1760,1.0,0,1060,700,1977,317000.0001
3,1.0,1250,1.0,0,1250,0,1951,326428.5715
3,1.5,1170,1.0,0,1170,0,1960,330000.0
3,2.5,1480,2.0,0,1180,300,2012,341000.0
3,1.0,1260,1.0,0,720,540,1944,342000.0
4,1.0,1980,1.5,0,1980,0,1962,345000.0
4,2.5,2440,2.0,0,2440,0,2009,350000.0
4,1.5,1370,1.0,0,900,470,1972,370000.0
4,2.5,2790,2.0,0,2790,0,2005,375000.0
3,1.5,1100,2.0,0,940,160,2007,375000.0
3,2.25,1410,2.0,0,1290,120,2005,377499.9999
3,3.25,1860,3.0,0,1860,0,2007,379950.0001
3,1.75,1180,1.0,0,940,240,1981,385000.0
3,2.5,2740,2.0,4,2740,0,1973,400000.0001
3,2.5,1800,2.0,0,1800,0,1990,408200.0
3,2.5,2670,1.0,0,2670,0,1988,425000.0001
4,2.5,2280,2.0,0,2280,0,2001,432999.9999
3,2.5,2320,2.0,2,2320,0,1992,437499.9999
3,1.75,2150,1.0,0,1200,950,1956,440825.0
3,3.0,1970,1.0,0,1970,0,2010,445000.0
3,2.25,1990,2.0,0,1990,0,1984,445000.0001
4,2.25,2270,1.0,0,1290,980,1977,446000.0
3,1.75,1560,1.5,2,1000,560,1926,451000.0
4,2.5,2430,2.0,0,2430,0,2009,480000.0001
3,2.0,1450,1.5,0,1450,0,1900,489999.9999
3,2.5,2370,2.0,0,2370,0,2003,522500.0001
3,1.5,1260,1.5,0,1260,0,1931,523000.0
1,1.0,1140,1.5,0,1140,0,1920,540000.0
2,2.0,2260,1.0,0,2260,0,1990,551000.0001
3,2.25,1520,3.0,0,1520,0,2013,565000.0
4,2.5,2110,2.0,0,2110,0,2000,577437.4999
3,2.5,2134,2.5,0,2134,0,2008,611000.0
3,2.5,2720,2.0,0,2720,0,2005,619000.0
3,2.5,2170,2.0,0,2170,0,2003,619499.9999
3,2.25,1720,1.5,0,1450,270,1921,620000.0
4,2.5,3160,2.0,0,3160,0,1983,645000.0
5,2.5,3200,2.0,0,3200,0,2009,674999.9999
2,1.0,2020,1.0,3,1700,320,1947,719999.9999
3,2.0,2050,1.0,0,1180,870,1926,724799.9999
5,2.75,2830,2.0,0,2830,0,2006,725000.0
4,2.5,3120,2.0,0,3120,0,2003,730100.0
3,2.0,2180,1.0,0,1100,1080,1904,785000.0001
4,3.25,3120,2.0,0,2370,750,2005,799000.0
5,1.5,3360,2.0,0,3360,0,2014,804995.0
4,2.75,3280,2.0,0,3280,0,1996,862500.0001
3,2.0,2220,1.0,2,1220,1000,1947,875000.0
4,3.0,5520,2.0,3,3570,1950,2008,1270000.0
5,4.25,6490,2.0,3,3940,2550,1991,2000000.0
3,2.0,1700,1.0,0,890,810,1944,410000.0
5,2.5,1970,2.0,0,1970,0,1994,297000.0
3,2.25,1410,1.0,2,1170,240,1987,352500.0
3,2.5,2480,2.0,0,2480,0,1986,415000.0
2,2.0,1360,1.0,0,780,580,1944,488000.0
3,2.5,2130,1.0,0,1210,920,1994,534640.0
4,2.5,2060,1.0,0,1440,620,1985,575550.0
3,2.0,1940,1.0,0,1940,0,1954,732000.0001
2,1.0,680,1.0,0,680,0,1941,110700.0
3,1.0,950,1.0,0,950,0,1954,137000.0
2,1.0,930,1.0,0,930,0,1942,141800.0
2,1.0,910,1.0,0,910,0,1981,176400.0
3,1.5,2200,1.5,0,2200,0,1932,193000.0001
3,1.0,1080,1.0,0,1080,0,1942,210000.0001
2,2.25,1610,2.0,0,1610,0,1979,215000.0
3,1.0,970,1.0,0,970,0,1970,215000.0
2,2.0,1470,2.0,0,1470,0,2005,241000.0
3,2.25,1580,2.0,0,1580,0,1986,247000.0
4,1.5,1310,1.0,0,1060,250,1953,251200.0
2,1.0,1120,1.0,0,1120,0,1980,256500.0001
4,1.75,2420,1.0,0,1480,940,1979,257500.0
3,2.5,1720,2.0,0,1720,0,2005,280000.0
3,2.5,1270,2.0,0,1270,0,1993,280000.0
4,1.75,2080,1.0,0,1040,1040,1955,285000.0
1,1.5,810,2.0,0,810,0,1982,285000.0
5,1.5,2120,1.5,0,2120,0,1962,290000.0
4,2.5,1700,2.0,0,1700,0,1988,290000.0
3,2.75,2170,1.0,0,1380,790,1978,296500.0001
5,3.0,2100,1.0,0,1200,900,2007,298450.0
3,1.75,1610,1.0,0,1610,0,1981,305000.0
3,1.0,1370,1.0,0,1370,0,1960,307000.0
4,1.75,2310,1.0,0,1650,660,1976,319949.9999
3,2.5,2680,2.0,0,2680,0,1990,319999.9999
4,2.0,1580,2.0,0,1580,0,1906,332999.9999
4,2.5,1830,2.0,0,1830,0,2003,339000.0
3,2.25,1640,2.0,0,1640,0,1985,350000.0
4,2.75,2070,1.0,0,1120,950,1945,366500.0001
2,1.5,1660,1.0,0,830,830,1908,367999.9999
3,2.5,1670,2.0,0,1670,0,1999,373000.0
3,2.5,1690,2.0,0,1150,540,2014,386591.0001
4,2.5,2490,2.0,0,2490,0,1999,390000.0
4,2.75,2500,2.0,0,2500,0,1966,411000.0
3,2.5,1920,2.0,0,1920,0,1995,429000.0001
3,2.5,2200,2.0,0,2200,0,2009,433500.0
2,1.5,1010,1.5,0,1010,0,1906,440000.0
3,1.75,1800,1.0,0,1800,0,1967,442500.0
5,2.75,2190,1.0,0,1370,820,1978,446000.0001
3,1.5,1710,1.5,0,1410,300,1928,462000.0
5,1.75,1250,1.0,0,1250,0,1966,462000.0
3,1.75,1630,1.0,0,1630,0,1967,464000.0
4,2.5,3060,1.0,0,1700,1360,1968,475000.0001
2,1.0,1490,1.0,0,860,630,1929,475000.0
3,2.5,1350,3.0,0,1350,0,2005,477000.0
3,2.25,1450,2.0,0,980,470,2005,482500.0
3,1.75,2200,2.0,2,2200,0,1908,485000.0
3,1.0,1500,1.5,0,1370,130,1926,485000.0
2,2.25,1260,3.0,0,1260,0,2004,485000.0
4,2.0,1690,1.5,0,1550,140,1901,487250.0
3,2.5,1680,2.0,0,1380,300,2008,518000.0
3,1.75,1890,1.0,0,1290,600,1974,524950.0001
3,3.5,2320,2.0,0,2060,260,1997,530000.0
4,1.0,1660,1.5,0,1260,400,1945,560000.0
4,2.25,2110,2.0,0,2110,0,1979,565000.0
3,2.25,2030,1.0,0,1500,530,1984,572500.0
4,2.5,2500,2.0,0,2500,0,2013,574999.9999
3,2.25,2030,1.0,0,1190,840,1977,588000.0
5,1.75,3290,1.5,0,3290,0,1973,601999.9999
4,2.5,2460,2.0,0,2460,0,1998,610999.9999
4,2.5,3430,2.0,0,3430,0,2013,646212.5
3,2.0,1610,1.5,0,1610,0,1940,690000.0
4,3.25,5010,2.0,0,5010,0,1988,692000.0001
3,1.75,2010,1.0,0,1230,780,1912,700000.0
4,2.5,2660,2.0,0,2660,0,1993,755000.0
5,2.0,3370,1.5,0,2140,1230,1907,762000.0001
4,2.5,3480,2.0,0,3480,0,1988,809999.9999
2,2.5,2380,1.0,2,2380,0,2011,818000.0
4,3.5,2640,2.0,2,2640,0,1937,849999.9999
5,3.25,4180,2.0,0,2880,1300,1979,869000.0001
4,2.75,2730,1.5,0,1550,1180,1921,885000.0001
2,1.75,2430,1.0,4,2430,0,1951,1000000.0
4,2.5,3190,1.0,3,1680,1510,1967,1216000.0
4,3.5,3410,2.0,0,3410,0,2008,1405000.0
3,1.75,1140,1.0,0,1140,0,1969,120750.0
2,1.0,950,1.0,0,950,0,1926,192500.0
1,1.0,820,1.0,0,760,60,2007,194000.0
3,1.0,1050,1.0,0,1050,0,1967,200000.0
4,2.0,1700,1.0,0,1700,0,1978,206000.0
3,1.5,1650,1.0,0,1090,560,1967,219950.0
2,1.0,1770,1.5,0,960,810,1943,243000.0
4,1.5,2500,1.0,0,1500,1000,1961,250000.0
4,2.0,1960,1.0,0,1160,800,1978,249999.9999
3,1.0,1320,1.0,0,1320,0,1957,259000.0
4,2.5,1990,2.0,0,1990,0,1989,260000.0
3,1.75,1570,2.0,0,1570,0,1982,263000.0
2,1.0,790,1.0,0,790,0,1953,268500.0
4,2.5,1860,1.0,0,1220,640,1983,268971.875
2,1.0,870,1.5,0,870,0,1906,271310.0
3,2.5,2090,2.0,0,2090,0,2002,289000.0
3,1.75,1560,1.0,0,1560,0,1964,291000.0
3,1.0,910,1.0,0,740,170,1950,299950.0
6,5.25,2860,2.0,0,2860,0,1978,300000.0001
3,1.0,2120,1.0,0,1060,1060,1967,300000.0001
3,1.0,1090,1.0,0,1090,0,1955,300000.0
2,2.5,1590,2.0,0,1220,370,2009,305000.0
3,1.0,1092,1.5,0,1092,0,1918,309000.0
3,2.25,1400,1.0,0,1140,260,1987,314999.9998
2,1.0,790,1.0,0,790,0,1955,315000.0
3,1.75,1280,1.0,0,1280,0,1969,317061.875
3,1.75,1480,1.0,0,1480,0,1965,320000.0
4,2.25,1870,1.0,0,1170,700,1959,325000.0
6,3.0,1880,1.0,0,1880,0,1966,326000.0
4,2.5,1600,1.0,0,830,770,1947,329000.0
3,2.5,2170,2.0,0,2170,0,2004,329900.0
4,2.5,2303,2.0,0,2303,0,2013,329995.0
3,1.0,1180,1.0,0,1180,0,1959,330000.0001
2,1.0,860,1.0,0,860,0,1948,330000.0
3,1.0,1060,1.0,0,1060,0,1967,335000.0
3,1.5,1240,1.0,0,1240,0,1954,345000.0
5,3.5,2800,2.5,0,2800,0,1903,345600.0
4,2.25,2220,2.0,0,2220,0,1999,350000.0
4,1.75,1590,2.0,0,1590,0,1922,372500.0
2,1.0,1150,1.0,0,1150,0,1947,376000.0
4,3.0,2800,2.0,0,2800,0,2002,380000.0001
3,1.75,1690,2.0,0,1380,310,2008,379999.9999
3,2.5,1700,2.0,0,1700,0,2003,384000.0
3,1.5,1490,1.0,0,1490,0,1959,385000.0
2,2.25,1230,2.0,0,960,270,2012,387000.0
4,1.0,1320,1.5,0,1320,0,1929,387500.0
4,2.25,1770,1.0,0,1190,580,1965,390000.0
3,1.5,1080,1.5,0,1080,0,1920,395000.0
2,1.0,1730,2.0,0,1730,0,1945,396674.9999
5,2.5,2430,2.0,0,2430,0,2001,405000.0
3,2.5,1800,2.0,0,1800,0,2014,409316.0
3,2.25,1970,2.0,0,1680,290,2008,415000.0
4,1.75,1940,1.0,0,970,970,1941,423000.0
4,2.5,2800,2.0,0,2800,0,2004,426000.0001
3,1.75,1200,1.0,0,1200,0,1906,430000.0
3,2.0,2010,2.0,0,1510,500,2003,439000.0009
3,1.5,1270,3.0,0,1270,0,2007,439999.9999
2,1.75,1300,2.0,0,1300,0,1948,440000.0
3,1.5,2060,1.0,0,2060,0,1953,450000.0001
4,1.0,1210,1.5,0,1210,0,1900,452000.0
1,2.25,2140,1.0,0,1470,670,1976,458000.0
3,2.25,1270,2.0,0,1040,230,2005,467000.0
4,1.75,1650,1.0,0,1150,500,1950,475000.0
4,2.75,2050,1.0,0,1180,870,1986,480000.0
2,1.75,1480,1.0,0,840,640,1951,483944.9999
5,3.5,4460,3.0,2,3280,1180,2013,489999.9999
3,1.0,1910,1.0,0,1010,900,1946,490000.0
4,1.75,2090,1.5,0,1250,840,1925,494000.0
5,3.5,3200,2.0,0,3200,0,1989,499949.9999
3,2.0,2020,1.0,0,1020,1000,1963,507500.0
4,2.5,2670,2.0,0,2670,0,2006,514999.9999
4,2.0,1820,1.0,0,1820,0,1967,519900.0
4,3.5,2680,2.0,0,2040,640,1942,520000.0
3,1.5,1540,2.0,0,1540,0,1941,524999.9999
3,2.5,2830,2.0,0,2830,0,2001,551000.0
5,2.25,2890,2.0,0,2890,0,1977,598000.0001
3,2.5,2660,2.0,0,2660,0,2014,599950.0
4,2.75,2820,1.0,0,1860,960,1965,614999.9999
3,2.5,1700,2.0,0,1700,0,1992,619500.0
3,2.5,2480,2.0,0,2480,0,2004,620000.0
4,2.5,3550,2.0,0,3550,0,2007,624999.9998
4,2.5,2150,2.0,0,2150,0,1982,639000.0
4,3.0,2690,1.0,0,2690,0,1954,674999.9999
3,2.25,1990,2.0,0,1990,0,1987,675000.0
4,2.5,2650,2.0,0,2650,0,2006,699000.0
4,2.5,3230,2.0,0,3230,0,2004,730000.0
3,2.5,2770,2.0,2,2770,0,1992,749950.0
6,2.0,2150,1.0,0,1270,880,1952,755000.0
4,1.75,2450,1.0,2,1630,820,1987,760000.0
4,2.25,2560,1.0,0,1760,800,1976,765000.0
4,3.5,3070,2.0,0,2190,880,2009,785000.0
4,2.75,3160,2.0,0,3160,0,2014,860000.0
4,2.25,3500,1.0,4,1830,1670,1938,879949.9999
4,2.25,2260,1.0,0,2260,0,1967,924999.9998
4,3.5,3120,2.0,0,2480,640,2008,953006.9999
4,2.75,2620,1.5,2,1720,900,1926,978000.0
3,2.0,2390,2.0,1,2390,0,1939,1100000.0
6,3.0,2880,2.0,0,2180,700,1919,1125000.0
4,3.5,4560,1.0,3,2230,2330,1995,1212500.0
4,3.5,4380,1.0,0,4380,0,2001,1300000.0
4,3.5,4460,1.0,0,2550,1910,1962,1800000.0
3,1.0,1010,1.0,0,1010,0,1966,150000.0
2,1.75,1100,1.0,0,1100,0,1980,189650.0
3,1.75,1380,1.0,0,990,390,1981,195000.0
2,1.0,1080,1.0,0,1080,0,1972,195000.0
3,1.0,1240,1.0,0,1240,0,1916,210000.0
3,1.0,1020,1.0,0,1020,0,1956,218000.0
4,2.5,2160,2.0,0,2160,0,1993,220000.0001
3,1.0,1060,1.0,2,1060,0,1956,220000.0
5,2.0,1930,1.5,0,1930,0,1941,230000.0
2,1.75,1330,1.0,0,1330,0,1993,240000.0
3,1.5,1780,1.0,0,1780,0,1953,246000.0001
2,1.0,1140,1.0,0,1140,0,1947,249900.0
3,2.0,1170,1.0,0,1170,0,1984,250000.0
3,1.5,1060,1.0,0,1060,0,1973,255000.0
3,2.5,1990,1.0,0,1570,420,1969,256750.0
6,2.0,2220,1.0,0,2220,0,1977,260000.0001
4,1.0,1310,1.5,0,1160,150,1945,266066.6667
3,1.75,1390,1.0,0,860,530,1957,270000.0001
3,2.5,2030,2.0,0,2030,0,1993,274999.9999
3,1.75,2380,1.5,0,1320,1060,1935,285000.0
3,2.25,1870,2.0,0,1870,0,1997,288400.0
2,1.0,790,1.0,0,790,0,1925,299800.0
3,2.5,2720,2.0,0,2720,0,2002,299900.0
2,1.0,970,1.0,0,970,0,1949,300000.0
4,2.25,2000,1.0,0,2000,0,1978,318989.0
3,1.0,990,1.0,0,990,0,1947,325000.0
3,1.0,1250,1.0,0,1250,0,1969,330000.0001
3,2.25,1800,2.0,0,1800,0,1995,332500.0
4,2.5,2220,2.0,0,2220,0,2014,334990.0
4,2.75,1800,1.0,0,1050,750,2002,344500.0
3,1.5,980,1.0,0,980,0,1969,350000.0
3,2.5,1530,3.0,0,1530,0,2009,360000.0001
3,2.5,2150,2.0,0,2150,0,1988,368250.0
3,1.75,2000,1.0,0,2000,0,1961,374000.0
3,2.0,1540,1.0,0,1120,420,1961,385500.0
3,2.25,1445,2.0,0,1300,145,2003,389999.0
3,1.75,1540,1.0,0,1540,0,1967,396450.0
3,1.75,2470,1.0,1,1570,900,1962,405000.0
3,2.0,1440,1.0,0,1440,0,2007,413800.0
1,1.0,960,1.0,0,960,0,1945,420850.0
3,2.75,2550,2.0,0,2550,0,1994,430000.0
3,1.0,1150,1.0,0,1150,0,1906,430000.0
4,2.25,2080,1.0,0,1220,860,1979,442000.0001
2,1.0,1200,1.0,0,1070,130,1940,450000.0
4,2.0,1660,1.0,0,850,810,1945,451999.9999
4,2.0,1790,1.0,2,840,950,1909,474999.9999
3,3.5,2380,2.0,3,1670,710,1997,495000.0001
3,2.5,1900,2.0,0,1900,0,1990,512499.9999
4,2.5,3290,2.0,0,3290,0,1992,520000.0
3,2.75,2100,2.0,0,1510,590,1998,525000.0
3,1.0,1450,1.0,1,950,500,1948,525000.0
4,2.5,1900,2.0,0,1900,0,1994,535800.0
3,1.75,1300,1.0,0,1300,0,1983,539999.9999
3,2.25,2020,2.0,0,2020,0,1998,556000.0
3,3.0,1960,2.0,0,1600,360,2007,556000.0
3,2.5,2540,2.0,0,2540,0,1999,567000.0001
4,2.5,2910,2.0,2,2910,0,1998,589000.0001
3,2.25,2230,2.0,0,2230,0,1987,599999.9999
4,2.5,2360,2.0,0,2360,0,2001,600000.0001
4,2.75,2450,2.0,0,2450,0,1988,619420.0001
4,2.5,2630,2.0,0,2630,0,1986,625000.0001
4,2.25,2750,1.0,0,1500,1250,1948,635000.0
4,3.5,2350,2.0,3,1670,680,1994,655000.0001
4,2.5,2340,1.0,2,1590,750,1964,668750.0001
4,2.75,2550,1.0,0,1700,850,1972,691000.0
4,2.5,3010,2.0,0,3010,0,1996,699999.9999
4,3.25,2780,2.0,0,2780,0,2006,700000.0
3,2.5,2020,3.0,3,2020,0,2000,720000.0
4,2.75,2830,2.0,0,2830,0,1998,743999.9999
4,2.75,3488,2.0,0,3488,0,1998,814999.9999
5,3.0,2876,1.0,2,1970,906,1973,895000.0
5,3.75,5330,2.0,2,3570,1760,2006,949999.9999
4,3.25,2790,1.0,3,1130,1660,1963,969999.9999
5,4.0,4850,2.0,0,4850,0,1977,975000.0002
4,2.75,2290,2.0,0,2170,120,1926,1003000.0
3,4.0,3880,2.0,3,3700,180,2009,1030000.0
4,3.25,3810,1.0,1,2680,1130,2007,1130000.0
3,2.25,2760,2.0,0,2760,0,1978,1185000.0
3,2.5,4460,2.0,0,4460,0,1992,1550000.0
2,1.0,820,1.0,0,820,0,1954,149999.9999
2,2.5,1160,2.0,0,1160,0,1998,168000.0
4,1.5,1740,1.0,0,1020,720,1962,180000.0
2,1.0,1400,1.0,0,900,500,1922,180000.0
3,1.0,870,1.0,0,870,0,1969,180000.0
3,1.0,910,1.0,0,910,0,1956,219900.0
2,1.0,740,1.0,0,740,0,1938,235750.0
4,2.25,1720,1.0,0,1720,0,1973,240015.3333
4,2.0,1580,1.0,0,1040,540,1967,245000.0
2,1.0,940,1.0,0,940,0,1959,249950.0
4,2.75,2570,2.0,0,1720,850,1998,254500.0
3,2.5,1550,2.0,0,1550,0,2011,259000.0
2,1.5,840,2.0,0,840,0,2005,270000.0
1,0.75,1170,1.0,0,880,290,1962,275000.0001
4,2.0,980,1.0,0,980,0,1978,295000.0
5,2.5,2760,2.0,0,2760,0,2006,300000.0
6,2.0,2040,1.0,0,2040,0,1943,300000.0
4,1.75,2200,1.5,0,1400,800,1942,305000.0
3,1.5,2320,1.0,0,2320,0,1976,307000.0
2,1.0,1070,1.0,2,1070,0,1949,319950.0
3,2.0,1110,1.0,0,1110,0,1978,320000.0
3,2.25,998,2.0,0,798,200,2007,320000.0
3,2.25,1347,3.0,0,1347,0,2010,321000.0
3,2.5,1750,2.0,0,1750,0,1994,324000.0
4,3.5,3150,2.0,0,3150,0,2005,330000.0
3,1.0,1070,1.0,0,1070,0,1951,337000.0
4,2.5,1980,2.0,0,1980,0,1988,342246.4286
3,1.0,1220,1.0,0,1220,0,1966,348580.0
4,2.5,2052,2.0,0,2052,0,2014,349900.0
2,1.0,1060,2.0,0,1060,0,1979,353250.0
3,2.25,1280,3.0,0,1280,0,2005,355000.0
2,1.75,1060,1.0,0,1060,0,1977,356000.0
3,1.5,1360,3.0,0,1360,0,2008,359000.0
3,1.0,1100,1.5,4,1100,0,1922,360999.9999
5,3.5,2420,2.0,0,2420,0,2013,380000.0001
2,2.5,1230,2.0,0,1060,170,2011,380000.0
3,1.0,1250,1.0,0,1250,0,1956,385000.0
4,2.5,3140,2.0,0,3140,0,1991,389950.0
3,1.0,1040,1.0,0,1040,0,1942,400000.0
3,2.25,1950,1.0,0,1950,0,2006,407999.9999
4,3.0,3220,2.0,0,2450,770,1990,430000.0
2,2.5,1520,2.0,0,1240,280,2007,430000.0
3,3.5,1900,2.0,0,1430,470,2008,431499.9999
3,2.75,2200,1.0,0,1100,1100,1982,432000.0
3,2.25,1470,2.0,0,1090,380,2007,432000.0
3,2.25,1820,1.0,0,1240,580,1981,475000.0001
4,2.25,3250,2.0,0,3250,0,1983,480000.0002
5,2.25,2230,1.0,0,1320,910,1978,481999.9999
4,2.0,1640,2.0,0,1640,0,1907,492000.0
2,1.75,1560,1.0,0,780,780,1904,494400.0001
2,1.75,2860,1.0,4,1510,1350,1948,503000.0
4,2.25,2350,1.0,0,1430,920,1977,555000.0
4,1.75,3000,1.0,3,1500,1500,1950,585000.0
4,3.0,2170,1.0,0,1370,800,1968,592500.0
3,1.75,1650,1.0,0,1040,610,1908,600000.0
4,2.75,2750,1.0,3,1720,1030,1981,604699.9999
4,2.5,2980,2.0,0,2980,0,2000,622499.9999
3,1.75,2060,1.0,0,1350,710,1984,625000.0
4,2.5,3240,1.0,0,1860,1380,1977,635699.9999
4,1.75,2260,1.0,1,1130,1130,1947,648360.0
4,2.5,2860,2.0,0,2860,0,1999,655000.0
4,1.75,2740,1.0,2,1370,1370,1954,657000.0
3,2.5,2670,2.0,0,2670,0,1989,657500.0001
3,2.5,2450,2.0,0,2450,0,2010,660000.0001
4,2.5,2600,2.0,0,2600,0,1996,665000.0
3,2.0,2000,1.0,0,1100,900,1916,677000.0001
4,2.5,2930,2.0,0,2930,0,1998,749000.0001
4,2.5,2350,2.0,0,2350,0,1987,770000.0
4,2.75,2410,1.0,0,1410,1000,1950,805000.0
4,3.25,3090,2.0,4,3090,0,2013,850000.0
4,3.25,3340,1.5,0,2240,1100,1963,909999.9999
4,3.0,4260,2.0,0,4260,0,1996,999999.9999
4,3.25,3440,2.0,0,3440,0,1983,1050000.0
4,2.5,3030,1.5,0,3030,0,1988,1050000.0
4,3.75,3860,2.5,0,3860,0,2007,1051000.0
4,3.0,3600,1.0,4,2100,1500,1976,1075000.0
3,2.75,2890,2.0,3,2830,60,1987,1170000.0
1,0.75,430,1.0,0,430,0,1912,79999.99999
2,1.0,580,1.0,0,580,0,1943,90000.0
3,1.0,1080,1.0,0,1080,0,1967,132500.0
2,1.0,1300,1.0,0,1300,0,1958,175000.0
4,1.0,1350,1.0,0,1350,0,1966,200000.0
3,1.0,960,1.0,0,960,0,1982,218000.0
2,1.0,1300,1.5,0,1300,0,1975,225000.0
4,2.5,1810,1.0,0,1230,580,1970,234999.9999
2,1.0,1140,1.5,0,1010,130,2007,235000.0
4,1.0,1450,1.0,0,1450,0,1943,244000.0
3,2.0,1490,1.5,0,1490,0,1984,255000.0
3,1.75,1620,1.0,0,1310,310,1988,258000.0
4,2.5,1960,2.0,0,1960,0,2001,259585.5714
4,1.5,1930,2.0,0,1930,0,1979,274999.9999
2,1.0,1340,1.0,2,1340,0,1947,300000.0
2,1.0,780,1.0,0,780,0,1946,306000.0
3,1.0,1920,1.0,2,1120,800,1952,325000.0
4,2.5,2210,1.0,2,1410,800,1965,334000.0001
4,2.5,1750,1.0,0,1240,510,1983,335000.0
3,1.0,1010,1.0,0,1010,0,1947,349999.9999
3,2.0,1220,3.0,0,1220,0,2007,355000.0
3,2.0,1270,3.0,0,1270,0,2006,360000.0
5,1.75,2120,1.0,0,1320,800,1942,377691.0001
3,1.0,1800,1.0,0,1200,600,1942,383000.0
4,2.5,2440,2.0,0,2440,0,1993,388000.0
3,1.75,2420,2.0,0,2420,0,1911,399500.0001
3,2.0,1540,2.0,0,1540,0,2005,401999.9999
3,2.0,1650,1.5,0,1650,0,1983,410000.0
3,1.5,1110,1.0,0,1110,0,1963,416000.0
4,1.75,1830,1.0,0,1010,820,1966,433000.0
4,2.5,2380,2.0,0,2380,0,2002,439950.0
4,2.5,2560,1.0,0,1280,1280,1965,440000.0001
3,2.0,1630,1.0,0,1630,0,1987,445000.0
3,2.0,1560,2.0,0,1560,0,1923,449950.0
3,1.0,1670,1.5,0,1170,500,1939,460000.0001
3,1.75,1300,1.0,0,820,480,1919,462000.0
3,1.75,1120,1.5,0,1120,0,1925,464600.0
4,2.75,2430,1.0,0,2430,0,1967,465425.0001
3,1.75,1620,1.0,0,1190,430,1973,467100.0
3,2.25,1670,2.0,0,1220,450,2002,505000.0
2,1.0,1680,1.0,0,1140,540,1941,515000.0
3,1.75,1680,1.0,0,960,720,1992,525999.9999
4,1.75,1814,1.0,0,944,870,1951,530000.0001
3,2.5,2210,2.0,0,2210,0,1994,534999.9999
4,3.0,2830,2.0,0,2830,0,1987,549899.9995
3,2.5,2510,2.0,0,2510,0,1992,550000.0
3,2.0,1830,1.0,0,1830,0,1959,550000.0
3,1.0,1430,1.0,0,1080,350,1919,552000.0
4,2.0,3510,1.0,2,2210,1300,1965,554819.9999
5,2.5,3840,2.0,0,3840,0,1991,556000.0
3,2.5,1620,3.0,4,1470,150,2008,580000.0
3,2.0,1670,1.5,0,1670,0,1931,585000.0
3,2.75,1960,1.5,0,1410,550,1926,599000.0
3,1.0,1500,1.0,0,1000,500,1947,606000.0
3,2.5,2600,1.0,0,2600,0,1984,625000.0
4,2.75,2250,1.0,0,1200,1050,1951,648474.9999
4,4.0,2290,1.5,0,1690,600,1940,661254.0
3,2.75,1800,1.0,0,1320,480,1966,665000.0
4,2.0,1590,1.0,0,1590,0,1951,670500.0
4,2.5,2560,2.0,0,2560,0,1987,675000.0001
3,2.5,2390,2.0,0,2390,0,1984,735000.0
4,2.5,2380,2.0,0,2380,0,1991,782000.0001
4,2.75,3500,2.0,0,3500,0,2005,788599.9999
4,2.25,2530,1.0,0,1570,960,1976,902000.0001
4,2.0,2840,1.0,0,1420,1420,1952,945000.0001
5,3.25,3400,2.0,0,3400,0,1999,950000.0
4,3.0,3680,1.0,3,2060,1620,1967,980000.0001
3,4.0,4380,2.0,0,4380,0,1983,1050000.0
4,3.5,4740,2.0,0,4740,0,2003,1200000.0
4,3.0,3370,1.0,3,1860,1510,1988,1325000.0
4,3.5,4390,2.0,3,3060,1330,1990,1610000.0
2,1.0,720,1.0,0,720,0,1943,199000.0
3,1.75,1260,1.0,0,1260,0,1994,245000.0
4,1.5,2670,2.0,0,2670,0,1996,347000.0001
4,1.75,1960,1.0,0,1340,620,1979,372000.0
3,2.5,2460,2.0,0,2460,0,2007,440500.0001
3,1.0,1370,1.5,0,1370,0,1924,479000.0
3,2.5,1740,2.0,0,1740,0,1989,496699.9999
4,2.5,3670,2.0,0,3670,0,2005,820000.0001
4,4.25,5584,2.0,0,5584,0,1998,1680000.0
3,1.75,1570,1.0,0,1570,0,1991,195000.0
3,2.5,1560,2.0,0,1560,0,2003,295000.0
4,3.5,2630,1.5,3,1640,990,1984,325000.0
3,2.5,1620,1.0,0,1620,0,1955,355300.0001
3,3.0,2980,1.0,0,1820,1160,1981,674999.9999
3,1.0,1140,1.0,0,1140,0,1972,172500.0
3,1.0,1140,1.0,0,1140,0,1960,276000.0
4,2.5,2100,2.0,0,2100,0,2009,346000.0001
3,2.5,1780,2.0,0,1780,0,2001,370000.0
3,1.5,1690,1.0,0,1140,550,1956,379950.0
2,1.5,2730,1.0,0,1570,1160,1976,459999.9999
4,2.5,2700,2.0,0,2700,0,2004,690000.0
3,2.0,2130,1.0,0,2130,0,1989,880000.0001
2,1.0,1180,1.0,0,1180,0,1918,160000.0
3,1.0,910,1.0,0,910,0,1971,244000.0
3,1.0,960,1.0,0,960,0,1955,255000.0
3,2.0,1630,1.0,0,1630,0,2003,260000.0
3,2.5,1658,2.0,0,1658,0,2014,263900.0
3,2.5,1440,1.0,0,1000,440,1983,265000.0
4,2.0,1930,1.0,0,1030,900,1967,268000.0
3,1.75,1670,1.0,0,1320,350,1987,274950.0
3,1.0,1200,1.0,0,920,280,1943,280000.0
3,2.5,1680,1.0,0,1240,440,1994,282000.0
4,2.5,1982,2.0,0,1982,0,2004,283200.0
5,3.0,2840,1.0,0,1710,1130,2003,292050.0
5,1.0,1410,1.0,0,960,450,1955,295832.0
3,1.0,900,1.0,0,900,0,1972,304000.0
4,1.0,2100,1.0,0,1050,1050,1968,305000.0001
3,1.5,1255,3.0,0,1255,0,2004,312000.0
4,2.5,1630,2.0,0,1630,0,2003,312900.0
3,1.75,1320,1.0,0,1320,0,1948,312999.9999
3,1.75,1780,1.0,0,1780,0,1983,325000.0
2,1.0,880,1.0,0,880,0,1942,326100.0
3,1.0,1810,2.0,0,1810,0,1970,326500.0
4,2.5,1720,1.0,0,1120,600,1961,328211.9048
3,1.0,1600,1.0,0,1150,450,1964,329000.0
4,2.0,2330,1.0,0,1400,930,1941,344950.0
2,1.5,1180,2.0,0,990,190,2005,345000.0
4,2.25,1810,2.0,0,1810,0,2003,354999.9999
3,1.0,1570,1.0,0,1570,0,1954,360000.0
3,1.0,1050,1.5,0,1050,0,1954,360000.0
2,2.25,1280,2.0,0,1080,200,2009,370000.0
3,1.5,2000,1.0,0,1520,480,1965,375000.0
3,1.75,1440,1.0,0,1440,0,1973,375000.0001
5,2.0,2330,1.0,0,1190,1140,1962,389000.0
4,2.5,2870,2.0,0,2540,330,1979,399000.0
3,3.0,1296,3.0,0,1296,0,2009,399950.0
2,1.0,1470,1.0,0,1470,0,1940,400000.0
3,1.75,1980,1.0,0,1310,670,1949,404999.9999
2,1.0,910,1.0,0,910,0,1942,405000.0
3,2.25,1950,1.0,0,1350,600,1964,415000.0
5,1.5,1900,1.0,0,1130,770,1961,415000.0
3,2.5,1870,2.0,0,1870,0,2003,425000.0
3,1.0,1270,1.5,2,1270,0,1928,435000.0
3,1.75,1650,1.0,0,1650,0,1961,438000.0
4,2.5,2520,2.0,0,2520,0,1999,450000.0
4,3.25,2510,2.0,0,2510,0,2009,450800.0
3,2.0,1460,1.0,0,1460,0,1975,455500.0
3,2.5,2420,2.0,0,2420,0,1998,455600.0
3,1.75,1840,1.0,0,1050,790,1925,457500.0
3,3.5,1600,2.0,0,1240,360,2006,460000.0
3,2.0,1560,1.0,0,1560,0,1967,465000.0
2,1.0,1160,1.0,0,860,300,1942,468000.0
4,2.75,1720,2.0,0,1720,0,1978,476999.9999
3,1.0,1150,1.0,2,1150,0,1943,480000.0001
3,2.5,1590,3.0,0,1590,0,1985,488000.0
4,2.25,1940,1.0,0,1430,510,1956,495000.0
3,2.5,1750,3.0,0,1750,0,2013,494999.9999
3,3.5,1820,2.0,0,1430,390,2014,499950.0
3,2.25,1760,2.0,0,1760,0,1988,500000.0
4,2.5,3200,2.0,0,3200,0,2005,515000.0001
5,3.0,2750,1.5,0,1750,1000,1926,524999.9999
4,2.5,2340,2.0,0,2340,0,1921,535000.0001
4,4.25,1960,2.0,0,1960,0,1940,540000.0
5,4.5,4850,2.0,0,4850,0,2001,569950.0002
3,1.75,1930,1.0,0,1930,0,1977,569999.9999
3,1.75,1850,1.0,0,1850,0,1983,585000.0
3,3.5,2710,2.0,0,1650,1060,2005,627000.0001
4,2.5,2740,2.0,0,2740,0,1990,673476.8182
3,2.5,2540,2.0,1,2540,0,1940,675000.0
3,2.5,2810,2.0,0,2810,0,2001,685000.0
4,3.0,3000,1.5,3,1970,1030,1913,688000.0
2,2.5,2160,1.0,0,2160,0,2002,715000.0
3,1.5,2500,1.5,2,1450,1050,1940,725000.0
3,2.5,2330,2.0,4,1410,920,2004,731999.9999
5,2.75,3390,2.0,0,3390,0,2004,735000.0
2,2.0,1880,1.5,0,1880,0,1902,751750.0
3,2.5,2610,2.0,0,2610,0,2014,754949.9999
4,2.5,3330,2.0,0,3330,0,2009,760000.0
3,3.0,2520,1.5,0,1560,960,1925,780000.0
4,2.5,2680,1.0,0,1380,1300,1952,800000.0
4,2.5,1850,1.0,0,1430,420,1978,829999.9999
4,3.0,3720,2.0,0,3720,0,1991,856999.9998
5,4.0,3720,2.0,0,3720,0,2005,960000.0
3,3.75,3250,2.0,2,2370,880,1951,967500.0
5,3.0,3480,2.0,0,3480,0,1964,970000.0
3,2.25,2510,1.5,2,1810,700,1932,994000.0
4,2.5,2920,1.0,3,1470,1450,1921,1050000.0
4,3.0,5940,2.0,4,4950,990,2004,1149000.0
3,3.25,3790,2.0,4,3790,0,1985,1600000.0
5,4.5,4590,2.0,0,4590,0,2009,1710000.0
2,1.0,780,1.0,0,780,0,1948,87500.0
2,1.0,720,1.0,0,720,0,1942,127160.0
3,1.0,820,1.5,0,820,0,1910,150000.0
2,1.0,740,1.0,0,740,0,1949,157499.9999
3,1.0,1100,1.0,0,1100,0,1969,168500.0
2,1.0,830,1.0,0,830,0,1996,175000.0
3,1.5,1430,1.0,0,1430,0,1953,178650.0
2,2.0,1390,2.0,0,1390,0,1986,186950.0
2,2.0,1700,1.0,0,850,850,1927,188999.9999
2,1.5,880,2.0,0,880,0,2007,210000.0
2,1.0,1320,1.0,0,1320,0,1943,215000.0
3,1.75,1210,1.0,0,1210,0,1983,215000.0
3,1.5,1560,1.0,0,1040,520,1964,224000.0
3,2.0,2030,1.0,0,1220,810,1979,224999.9999
3,2.5,1680,2.0,0,1680,0,1994,225000.0
4,2.25,1830,1.0,0,1200,630,1989,236000.0001
3,1.75,1310,1.0,0,1310,0,1979,242000.0
3,2.5,2060,2.0,0,2060,0,1999,244615.0
3,1.75,1300,1.0,0,1300,0,1996,245100.0
3,2.0,1400,1.0,0,1400,0,1968,253400.0001
3,2.0,1480,1.0,0,1480,0,1992,254000.0
2,1.0,1060,1.0,0,1060,0,1952,254000.0
3,1.5,1430,1.0,0,1430,0,1966,266200.0
3,2.5,2495,2.0,0,2495,0,2007,267000.0
3,1.75,1300,1.0,0,650,650,1918,270000.0
4,1.0,1450,1.0,0,990,460,1964,277000.0001
3,1.0,1180,1.5,0,1180,0,1946,282508.8889
2,1.0,800,1.0,0,800,0,1954,285000.0
3,1.0,1390,1.5,0,1390,0,1954,299000.0
3,1.0,1160,1.0,0,1160,0,1968,305000.0001
3,2.5,1680,2.0,0,1680,0,1984,306000.0
3,1.0,1430,1.5,0,1430,0,1927,310000.0
2,2.5,1050,2.0,0,1050,0,2005,325000.0
3,2.75,1720,1.0,0,1720,0,1958,326000.0
4,2.0,1480,1.0,0,740,740,1910,335000.0
3,2.25,2180,2.0,0,2180,0,1986,341749.9999
2,1.0,1080,1.0,0,1080,0,1940,345000.0
3,2.5,2400,1.0,0,2400,0,1990,355000.0
2,1.0,1270,1.0,0,960,310,1920,354999.9999
4,2.5,3753,2.0,0,3336,417,2008,363000.0
3,1.5,1300,1.0,0,1300,0,1963,365000.0
3,2.0,1660,1.0,0,1660,0,1949,380000.0
3,2.5,2250,2.0,0,2250,0,2006,395000.0
3,1.75,1820,1.0,0,1250,570,1977,420000.0
4,2.75,1680,1.0,0,1080,600,1979,425000.0
2,1.75,1350,1.0,0,1350,0,2005,429000.0
3,3.75,3890,1.0,2,2390,1500,1943,430000.0002
3,1.75,1980,1.0,0,1270,710,1965,432500.0
4,3.0,4260,2.0,2,4260,0,2000,435000.0001
3,1.75,1610,1.0,0,1610,0,1947,438750.0
3,1.0,1100,1.0,0,1100,0,1917,450000.0
3,2.0,1300,1.0,0,900,400,1993,450385.7143
4,3.0,2230,2.0,0,2230,0,1991,460000.0
6,3.25,4250,1.0,3,2150,2100,1967,465000.0
3,2.25,1840,2.0,0,1840,0,2003,465000.0
2,3.25,1400,3.0,0,1400,0,2000,474800.0
3,2.0,1980,1.0,0,1980,0,1994,479900.0
4,2.5,2360,2.0,0,2360,0,2003,490000.0
4,2.5,2798,2.0,0,2798,0,2012,499950.0
4,1.5,2040,1.0,0,1020,1020,1961,510000.0
3,1.75,1400,1.0,0,870,530,1951,510250.0
4,2.5,2680,2.0,0,2680,0,2004,515000.0
2,1.75,2050,1.0,0,2050,0,1950,532500.0001
3,2.5,1720,2.0,0,1720,0,1994,535000.0
3,2.5,1550,2.0,0,1550,0,1999,537000.0
4,2.5,2230,1.0,0,1450,780,1974,544500.0001
4,1.0,1660,1.0,0,930,730,1933,550000.0
3,2.5,3160,2.0,0,2650,510,2006,555000.0
7,4.5,4140,1.0,0,2070,2070,1978,564999.9999
5,2.0,1940,1.0,0,970,970,1945,580000.0
3,2.0,1650,2.0,0,1650,0,1926,590000.0
4,2.75,2020,1.0,0,1010,1010,1917,599000.0
4,2.0,2510,1.0,0,2510,0,1960,600000.0
3,1.75,1580,1.0,0,1150,430,1967,600000.0
4,2.5,2740,2.0,0,2740,0,1993,630000.0
3,2.5,2300,1.5,0,2000,300,1921,635000.0
4,2.5,2990,2.0,0,2990,0,2003,654999.9999
3,2.5,2190,2.0,0,2190,0,1987,665000.0001
3,1.0,1700,1.5,0,1700,0,1907,681000.0
4,2.5,3150,2.0,0,3150,0,2006,681715.9999
4,3.5,4490,2.0,0,3390,1100,2006,699999.9998
2,1.75,2320,1.5,2,1720,600,1925,700000.0
3,2.5,2810,2.0,0,2810,0,2005,738999.9999
4,2.25,2920,2.0,0,2920,0,1998,740000.0002
2,1.75,2080,1.0,0,1080,1000,1923,740000.0001
4,3.5,3910,2.0,0,3130,780,2007,782000.0
4,2.25,2000,2.0,0,2000,0,2001,815000.0
3,2.5,2510,2.0,2,2510,0,1995,820000.0001
4,2.5,3420,2.0,0,3420,0,2000,840000.0001
4,2.75,3040,2.0,0,2100,940,1906,840000.0
3,2.0,2520,1.5,0,1410,1110,1906,840500.0
3,2.75,2280,1.0,0,1280,1000,1917,875000.0001
5,1.5,2680,1.0,0,1450,1230,1963,898000.0
6,2.75,2300,1.5,0,2300,0,1950,900000.0001
3,2.5,2690,2.0,0,1840,850,1943,925000.0
4,2.25,2410,2.0,2,1800,610,1929,960000.0
6,2.75,3610,1.0,4,2070,1540,1959,968000.0
7,4.0,3150,1.0,0,3150,0,1957,999000.0002
4,2.75,3650,2.0,2,2530,1120,1951,1210000.0
4,2.5,3240,1.0,0,2260,980,1946,1285000.0
4,3.25,4700,1.0,4,2520,2180,2005,1400000.0
3,1.0,1010,1.0,0,1010,0,1954,145000.0
3,1.0,1250,1.0,0,1030,220,1949,155000.0
2,1.0,1500,1.5,0,880,620,1928,156766.6666
3,1.75,1590,2.0,0,1590,0,1986,210000.0
2,1.0,950,1.0,0,950,0,1958,230000.0
4,2.0,1530,2.0,0,1530,0,1942,231000.0001
3,1.5,1270,1.0,0,1270,0,1964,246499.9999
2,1.0,1110,1.0,0,1110,0,1951,250000.0001
3,1.5,1470,1.0,0,1470,0,1958,264000.0
4,2.25,1720,1.0,0,1120,600,1978,264950.0
4,1.75,1880,1.0,0,1180,700,1978,266500.0
3,1.75,1590,1.0,2,1090,500,1957,267500.0001
4,2.5,2290,2.0,0,2290,0,2001,295000.0
3,2.5,2080,2.0,0,2080,0,1989,300000.0
2,1.0,820,1.0,0,820,0,1916,300000.0
2,2.25,1000,3.0,0,1000,0,2006,305000.0
2,1.0,810,1.0,0,810,0,1919,308830.7693
3,1.5,1460,1.0,0,1100,360,1971,329932.0
3,2.25,2270,1.0,0,1380,890,1977,332000.0001
4,1.75,1700,1.0,0,1120,580,1981,349000.0
4,2.5,2040,2.0,0,2040,0,2011,350000.0
2,1.0,1320,1.5,0,1320,0,1909,395000.0
5,2.0,1930,1.0,0,1020,910,1962,400000.0
4,1.5,1390,1.0,0,1140,250,1965,400000.0
4,2.0,1670,1.0,0,1670,0,1955,400000.0001
4,2.75,1240,1.0,0,800,440,1987,400000.0
5,1.75,1880,1.0,0,960,920,1963,405000.0001
3,2.0,1240,1.0,0,1240,0,1988,405000.0
3,1.75,2930,1.0,0,2030,900,1993,408900.0
3,1.75,1950,1.0,0,1950,0,1985,411999.9998
2,1.0,1260,1.0,0,1040,220,1951,436500.0
4,1.75,1990,1.5,0,1190,800,1944,445000.0
4,2.0,2240,1.0,0,1120,1120,1956,450000.0001
4,2.25,2590,1.0,0,1340,1250,1968,452000.0
6,2.5,4410,1.0,2,2350,2060,1965,472000.0001
3,1.0,2110,1.0,0,1110,1000,1924,475300.0
4,2.75,2320,2.0,0,2320,0,2012,484991.6667
4,1.0,1600,1.5,0,1600,0,1916,485000.0
3,2.0,2590,2.0,0,1980,610,1988,503000.0002
3,1.5,2240,2.0,0,1370,870,1929,510000.0001
3,3.0,2600,1.5,3,1890,710,1989,524999.9999
5,2.5,2630,2.0,0,2630,0,2003,525000.0001
3,1.0,1590,1.0,0,1590,0,1944,529000.0
3,1.5,2600,1.0,0,1400,1200,1940,539999.9999
5,2.0,2450,1.0,0,1240,1210,1900,550000.0
4,2.5,2440,2.0,0,2440,0,1996,565000.0
3,2.0,1480,1.0,0,750,730,1928,595000.0
4,2.5,2760,2.0,0,2760,0,1999,602500.0
4,2.0,2300,1.5,0,1550,750,1915,619000.0001
4,1.75,1640,1.0,0,920,720,1921,635200.0
3,3.25,1730,2.0,2,1320,410,2008,645000.0
3,2.5,2930,2.0,0,2930,0,2008,650880.0
4,2.75,3310,2.0,0,3310,0,2008,658000.0
3,2.5,2620,2.0,0,2620,0,1992,671999.9999
4,2.75,2620,2.0,0,2620,0,2000,672500.0
3,2.25,2330,1.5,2,1520,810,1927,680000.0001
3,1.75,1940,1.0,1,1440,500,1960,685000.0001
4,2.5,2920,2.0,0,2920,0,1990,689999.9999
3,2.5,2390,2.0,0,2390,0,2006,695000.0001
4,2.25,1960,1.0,0,1290,670,1959,723000.0
5,3.0,2170,1.5,0,1450,720,1911,750500.0001
5,3.25,2900,1.0,0,1890,1010,1967,790000.0
4,2.25,2280,1.5,2,1960,320,1940,820000.0001
3,2.5,2770,2.0,0,2770,0,1991,859999.9999
4,3.5,4140,2.0,0,4140,0,2000,950000.0
4,4.25,4960,2.5,0,3680,1280,1909,1425000.0
2,1.5,1220,1.5,0,1220,0,1976,168000.0
4,1.0,1290,1.5,0,1290,0,1957,173666.6667
3,2.25,1590,1.0,0,1090,500,1978,189999.9999
3,2.0,1560,1.0,0,1560,0,1992,196440.0
3,2.0,2120,1.0,0,2120,0,1991,237481.2501
3,2.0,1330,1.0,0,630,700,1900,240000.0
2,1.0,1000,1.0,0,1000,0,1942,247875.0
3,1.75,1050,1.0,0,1050,0,1980,260000.0
2,1.0,1880,1.0,0,940,940,1919,279999.9999
2,1.0,1090,1.0,0,730,360,1942,287919.7826
3,1.0,1210,1.0,0,1210,0,1955,299950.0
3,2.5,2260,2.0,0,2260,0,1994,309487.5
3,2.0,1060,1.0,0,1060,0,1981,315000.0
4,2.5,2280,2.0,0,2280,0,1994,322000.0001
3,1.75,2180,1.0,0,1090,1090,1961,325000.0
3,2.25,1490,2.0,0,1490,0,2009,326983.3333
2,2.5,1240,2.0,0,1240,0,2007,330000.0
3,2.5,2200,2.0,0,2200,0,1990,349900.0
3,2.0,1550,1.0,0,1150,400,1959,369000.0
3,1.0,1200,1.0,0,1200,0,1971,374000.0
3,2.5,1860,2.0,0,1860,0,2000,384949.9999
3,1.0,1220,1.0,0,1220,0,1901,385000.0
4,2.5,2910,2.0,0,2910,0,2002,395000.0
2,1.75,1340,1.0,0,1340,0,2004,415000.0
3,1.75,1510,1.0,0,1240,270,1989,425000.0001
3,1.75,1680,1.0,2,840,840,1900,425000.0
3,2.25,1820,1.0,0,1260,560,1974,425000.0
5,2.75,2220,1.0,0,1230,990,1973,427000.0001
5,2.5,3090,1.0,0,2990,100,1957,458000.0
3,1.75,2580,1.0,0,1290,1290,1951,459900.0
4,2.25,1820,1.0,0,1340,480,1977,465000.0001
3,1.75,1920,1.0,2,960,960,1947,490000.0
4,2.75,2620,2.0,0,2620,0,2013,499431.0
3,2.5,1950,2.0,0,1950,0,1988,530000.0
4,2.5,2720,2.0,0,2720,0,2012,545000.0
3,1.5,2000,1.0,0,2000,0,1953,560000.0
4,2.0,2340,1.0,0,1170,1170,1966,567999.9999
4,3.25,4240,2.0,3,3550,690,1989,624999.9999
3,2.5,2670,1.0,0,2670,0,1987,642000.0
4,2.5,2560,2.0,0,2560,0,1992,642000.0
2,1.0,1890,1.5,0,1890,0,1909,645500.0
2,2.5,1740,2.0,2,1210,530,1994,650000.0
4,2.25,2060,1.0,0,1440,620,1983,655000.0
4,2.5,3190,1.0,0,2210,980,1946,659000.0001
4,2.5,2310,1.5,0,1490,820,1927,700000.0
4,1.75,3420,1.0,3,1770,1650,1947,714999.9999
4,3.0,2840,1.5,0,2060,780,1931,735000.0
5,3.75,3990,2.0,0,3090,900,1937,740000.0
4,2.75,2600,1.0,0,1560,1040,1976,750000.0001
4,2.5,2310,2.0,0,2310,0,2013,790000.0
3,2.5,2780,2.0,0,2780,0,2009,825500.0
7,4.5,4290,1.5,0,4290,0,1982,840000.0002
3,2.25,3060,2.0,0,3060,0,1983,860000.0001
4,3.5,3760,2.0,0,2860,900,2014,919204.0
4,1.75,2500,1.0,0,1500,1000,1970,949999.9997
4,2.5,3150,2.0,0,3150,0,1966,1256500.0
6,2.75,5700,1.0,4,2850,2850,1977,1385000.0
3,2.5,1960,2.0,0,1960,0,2004,289950.0001
5,2.75,2080,2.0,0,2080,0,1987,538888.0001
4,2.5,2550,2.0,0,2550,0,1992,587000.0
3,2.25,1760,3.0,0,1760,0,2014,615000.0
3,2.25,2675,2.0,0,2675,0,1984,660000.0
3,2.5,2460,2.0,0,2460,0,1996,692999.9999
3,1.75,1790,1.0,0,1040,750,1960,243000.0
1,1.0,750,1.0,0,750,0,1918,250000.0
3,1.75,1620,1.0,0,1090,530,1974,459000.0
4,1.75,2780,2.0,0,2780,0,1978,659999.9999
4,3.5,3480,2.0,0,2580,900,1926,1505000.0
3,1.0,1010,1.0,0,1010,0,1969,199950.0
4,2.0,1850,1.0,0,1540,310,1978,250000.0
4,2.5,1920,2.0,0,1920,0,1998,270000.0
3,1.0,1450,1.0,0,1050,400,1958,274950.0
3,2.0,1380,1.0,0,1380,0,2008,275000.0
2,2.5,1380,2.0,0,1140,240,2011,285000.0
3,2.5,2080,2.0,0,2080,0,2002,290000.0
3,2.5,1950,2.0,0,1950,0,2010,298000.0
4,2.5,2070,2.0,0,2070,0,2003,300000.0001
3,1.0,950,1.0,0,950,0,1950,305000.0
2,1.5,1140,2.0,0,1140,0,1988,305000.0
3,1.0,960,1.0,0,960,0,1952,315000.0
3,2.25,2130,1.0,0,1570,560,1987,316000.0
5,2.5,3020,1.0,0,1510,1510,1978,319999.9999
3,1.5,1320,1.0,0,1320,0,1970,327000.0
2,2.5,1175,2.0,0,740,435,2005,342000.0
3,1.75,1990,1.0,1,1320,670,1963,345000.0
3,2.5,2680,2.0,0,2680,0,1990,350000.0
3,1.75,1510,1.0,0,1510,0,1967,366000.0
2,1.0,1210,1.0,0,1060,150,1950,380000.0
3,2.25,1410,2.0,0,1290,120,2004,391000.0
3,2.5,1495,3.0,0,1405,90,2006,400000.0
3,1.5,2030,1.0,0,1330,700,1963,404000.0
2,1.75,1710,2.0,0,1330,380,1920,404999.9999
4,1.75,1790,1.0,0,1490,300,1969,410000.0
4,2.75,2150,1.0,0,1240,910,1976,411000.0
3,2.5,2240,2.0,0,2240,0,2002,432500.0
3,1.5,1120,1.0,0,1120,0,1956,439800.0
2,2.0,1410,1.5,0,1410,0,1909,439900.0001
4,2.75,2340,1.0,0,1720,620,1967,439999.9999
2,1.0,1170,1.0,0,970,200,1941,455000.0
3,1.75,1890,1.0,0,1290,600,1965,465500.0
3,1.0,950,1.5,0,950,0,1948,469000.0
3,2.0,1750,1.0,0,1490,260,1982,472500.0
3,1.75,2770,1.0,0,1580,1190,1978,491999.9999
3,2.0,1720,1.0,2,960,760,1941,500000.0
4,2.5,2910,2.0,2,2910,0,2006,525000.0
3,2.5,1690,2.0,0,1690,0,1984,535000.0
4,1.75,1720,1.5,0,1460,260,1925,540000.0
5,2.75,2910,1.0,0,1590,1320,1977,542804.7501
3,1.5,1790,1.5,1,1790,0,1910,544000.0
3,2.0,1810,1.5,0,1810,0,1925,550000.0
3,2.75,2930,1.0,0,1860,1070,2004,559900.0001
3,2.75,2180,1.0,0,1310,870,1981,568500.0
4,2.5,2220,2.0,0,2220,0,1988,580000.0001
5,2.5,3990,1.0,0,1990,2000,1962,610000.0
4,2.5,2150,2.0,0,2150,0,1985,615000.0
3,2.0,1760,1.0,0,960,800,1920,629000.0
3,2.5,1960,1.0,0,980,980,1940,635000.0
4,2.5,2430,1.0,0,1670,760,1963,645000.0001
3,2.5,2290,2.0,0,2290,0,2006,653000.0
4,2.25,1990,1.5,2,1420,570,1932,661000.0
4,2.5,2720,2.0,0,2720,0,1987,664999.9999
4,2.5,2710,2.0,0,2710,0,1999,668500.0
3,2.25,2610,2.0,0,2610,0,1988,675000.0
3,2.5,1840,1.0,0,920,920,1926,678333.3332
3,1.5,1840,2.0,0,1840,0,1961,686000.0
4,2.75,3270,2.0,0,3270,0,2014,723243.75
4,2.5,3190,2.0,2,3190,0,2001,725995.0
4,2.0,2360,1.0,0,1260,1100,1939,730000.0
3,3.0,3740,2.0,2,3740,0,1991,789000.0001
2,2.5,2210,1.0,0,2210,0,2003,802000.0
3,1.75,2160,1.0,0,1390,770,1960,820000.0
4,3.0,4500,2.0,2,3040,1460,1980,870000.0001
3,2.25,3020,2.0,0,2720,300,1969,955000.0
3,2.5,2730,2.0,0,2730,0,1998,1000000.0
5,3.25,3160,2.0,0,3160,0,1972,1250000.0
3,1.0,1200,1.0,0,1200,0,1969,108333.3334
3,1.0,1040,2.0,0,1040,0,1942,148612.5001
2,2.5,1240,2.0,0,1240,0,1986,174500.0
3,1.5,1180,1.0,0,1180,0,1960,193000.0
3,1.0,1060,1.0,0,1060,0,1962,206000.0
3,1.0,1110,1.0,0,1110,0,1962,210000.0
3,2.0,1200,1.0,0,1200,0,1995,222400.0
3,1.0,1030,1.0,0,1030,0,1961,223000.0
3,2.0,1440,1.0,0,720,720,1942,230000.0
2,1.0,940,1.0,0,940,0,1952,234000.0
3,1.0,1250,1.0,0,1250,0,1959,235000.0
3,2.0,1530,1.0,0,1530,0,1970,235000.0
2,1.0,720,1.0,0,720,0,1947,235000.0
3,1.75,1340,1.0,0,1340,0,1968,239000.0
3,2.25,1765,2.0,0,1765,0,1996,250000.0001
2,1.75,1220,1.0,0,860,360,1921,253000.0
3,1.75,1970,1.0,0,1970,0,1966,268000.0
3,1.75,1590,1.5,0,1590,0,1926,269187.4999
3,2.0,1410,1.0,0,1410,0,1983,272500.0
2,1.5,1480,1.0,0,1480,0,1940,280000.0
2,1.0,1170,1.0,0,1170,0,1963,295000.0
5,2.75,2481,2.0,0,2481,0,2014,309000.0001
4,2.5,1830,2.0,0,1830,0,2003,312000.0
3,2.25,1540,1.0,0,770,770,1954,312000.0
3,2.0,1880,1.0,0,940,940,1952,319999.9999
3,3.25,1530,2.0,0,1140,390,2013,320000.0
3,1.75,2250,1.0,0,2250,0,1980,325000.0
3,2.5,1950,2.0,0,1950,0,1990,328500.0
5,2.75,2670,2.0,0,2670,0,2014,341166.6668
4,2.5,2240,2.0,0,2240,0,2014,363990.0
6,1.5,2550,1.0,0,1750,800,1958,375900.0001
3,2.0,1080,1.0,0,1080,0,1947,390000.0
3,1.5,1200,1.0,0,1200,0,1962,399999.9999
3,2.25,1450,2.0,0,1450,0,2009,400000.0
3,3.25,2780,2.0,0,2780,0,2009,402500.0001
2,1.75,1370,1.0,0,1370,0,1944,409950.0
3,1.75,1660,1.0,0,1380,280,1981,420000.0001
3,2.25,1870,1.0,0,1440,430,1978,425000.0
3,2.25,1660,1.0,0,1110,550,1979,425000.0
2,2.5,1140,3.0,0,1140,0,2007,425000.0
3,3.0,2340,2.0,0,2340,0,2013,427874.0
4,2.25,1790,1.0,0,1110,680,1973,430000.0001
3,2.0,1360,1.5,0,910,450,1924,430000.0
3,2.5,1970,2.0,0,1970,0,2003,432000.0001
3,1.75,2220,1.0,0,1110,1110,1988,435000.0004
3,2.25,1680,2.0,0,1680,0,1989,440000.0
2,1.0,1230,1.0,0,1130,100,1906,440000.0001
5,2.75,2040,1.0,0,1200,840,1969,449500.0
4,2.5,3030,2.0,0,2020,1010,1998,471000.0001
3,2.25,1800,1.0,0,1800,0,1976,474900.0001
3,2.5,2600,2.0,0,2600,0,1989,474999.9999
4,2.25,2220,1.0,0,1110,1110,1961,495000.0
3,1.75,1620,1.0,0,830,790,1945,500000.0
3,2.5,2190,2.0,0,2190,0,1999,503000.0001
4,2.25,2290,2.0,0,2120,170,1958,535000.0
3,1.75,1810,1.5,0,1810,0,1903,544999.9999
3,2.5,2110,2.0,0,2110,0,2001,548000.0
4,2.5,2170,1.0,0,1460,710,1980,550000.0
3,1.75,2000,1.0,0,1400,600,1963,560000.0
3,2.25,2090,2.0,0,2090,0,1983,562099.9999
3,2.25,3800,1.0,0,3330,470,1976,574999.9999
4,2.75,3120,2.0,0,3120,0,2010,575000.0001
4,2.5,3150,2.0,0,3150,0,2014,580134.9998
4,4.25,2360,2.0,0,2360,0,1939,590000.0
4,2.0,2580,1.0,0,1300,1280,1950,596165.4286
4,2.5,2620,2.0,0,2620,0,1987,600000.0
4,2.5,1960,1.0,1,1290,670,1958,600000.0
3,2.0,2060,1.0,0,1120,940,1947,605000.0
5,2.5,2070,1.0,0,1340,730,1967,613000.0
3,2.5,2370,2.0,0,2370,0,1993,640000.0
5,2.75,2550,1.5,0,2550,0,1902,650000.0
4,2.5,2790,2.0,0,2790,0,1987,654949.9998
3,2.5,2290,3.0,0,2290,0,1953,660000.0
5,2.75,3040,2.0,0,3040,0,1993,667781.2499
3,2.75,2390,1.0,0,1390,1000,1942,689800.0001
4,2.5,2961,2.0,0,2961,0,1998,695000.0
3,2.0,2140,1.0,0,1070,1070,1928,710000.0001
3,1.5,1660,1.0,0,1660,0,1956,712499.9999
3,2.0,2050,1.0,0,2050,0,1951,713250.0
4,2.5,2870,2.0,0,2870,0,1986,719999.9999
3,2.5,2430,2.0,0,2430,0,1987,770000.0002
5,1.0,2550,2.5,0,2550,0,1905,847000.0001
4,2.25,3720,1.0,2,1860,1860,1970,874999.9999
2,2.5,2680,1.0,0,2680,0,2006,930000.0
5,3.5,3490,2.0,4,2460,1030,1980,941499.9999
4,3.0,4590,2.0,0,3490,1100,1981,959999.9999
4,3.75,4130,2.0,0,4130,0,2001,1070000.0
1,1.0,650,1.0,0,650,0,1967,129000.0
1,1.0,790,1.0,0,790,0,1942,135000.0
4,1.75,1720,1.0,0,1220,500,1974,161700.0
2,1.0,1500,1.0,0,1500,0,1950,170000.0
2,1.0,670,1.0,0,670,0,1919,175000.0
5,2.0,1750,1.0,0,1750,0,1943,189999.9999
3,1.0,920,1.0,0,920,0,1977,212500.0
3,2.25,1500,1.0,0,1150,350,1984,219950.0
3,1.75,1730,1.0,0,1730,0,1972,228944.4445
3,1.75,1460,1.0,0,990,470,1997,240500.0
4,2.0,2120,1.5,0,2120,0,1960,250000.0
3,2.0,1710,2.0,0,1710,0,1988,250500.0
3,1.5,1810,1.0,0,950,860,1983,261000.0
3,2.25,2080,1.5,0,1550,530,2003,270000.0
3,2.5,1720,1.0,0,1000,720,1983,274999.9999
2,1.0,770,1.0,0,770,0,1948,275000.0
2,1.0,960,1.0,0,960,0,1942,280000.0
3,2.5,2437,2.0,0,2437,0,2011,285000.0
3,2.0,1670,1.0,0,1670,0,1992,289950.0
3,2.0,1350,1.0,0,1110,240,1995,310000.0
3,1.0,1010,1.0,0,1010,0,1959,317000.0
3,1.5,1650,1.0,0,1130,520,1978,320000.0001
3,1.0,1210,1.0,0,1210,0,1949,324950.0
4,1.75,1650,1.0,0,1650,0,1968,327500.0
3,1.0,1070,1.0,0,1070,0,1989,327500.0
4,2.75,2540,1.0,0,1600,940,1979,335000.0
3,1.75,2190,2.0,0,2190,0,1978,340000.0
2,1.75,1650,1.0,0,950,700,1947,355000.0
4,2.5,2310,2.0,0,2310,0,1978,364949.9999
2,1.0,1250,1.0,0,1250,0,1947,365000.0
3,1.5,1420,1.0,0,1420,0,1959,371000.0
4,1.75,2200,1.0,0,1100,1100,1955,375000.0
2,1.0,820,1.0,0,820,0,1922,375000.0
3,2.25,1250,1.0,0,1250,0,1942,390000.0001
3,1.0,1240,1.0,0,1240,0,1952,389999.9999
4,2.5,2150,2.0,0,2150,0,2005,392500.0
3,1.5,2080,1.0,0,1190,890,1959,399950.0
3,2.0,2260,1.0,0,1130,1130,1986,400000.0
3,1.75,1530,1.0,0,1530,0,1986,400000.0
3,1.75,1840,1.0,0,1040,800,1952,411715.0
4,2.5,2000,2.0,0,2000,0,1999,415000.0
3,2.5,2060,2.0,0,2060,0,2007,418500.0001
4,2.5,2460,2.0,0,2460,0,2003,427500.0
2,1.75,1500,1.0,0,910,590,1942,437000.0
5,2.5,2300,1.0,0,1170,1130,1967,453500.0001
3,1.75,1420,3.0,0,1420,0,2006,455000.0
3,2.0,1800,1.0,0,1800,0,1956,470000.0
3,2.5,2340,1.0,0,2340,0,1985,484999.9999
3,2.5,1520,2.0,0,1040,480,2007,499950.0
5,3.0,2920,2.0,0,2920,0,2003,500000.0
3,3.25,1540,2.0,0,1540,0,2011,520000.0
3,2.0,1540,1.0,0,1540,0,2004,525000.0
4,1.75,2020,1.0,0,1430,590,1979,531999.9999
3,2.5,1820,2.0,0,1820,0,1993,532000.0001
3,2.5,1710,2.0,0,1570,140,2005,539000.0
5,2.5,2730,1.0,0,1660,1070,1958,545000.0
4,2.25,2740,2.0,0,2740,0,1991,549000.0001
4,2.75,3370,2.0,0,3370,0,1991,557125.0002
3,2.5,2070,2.0,0,2070,0,1996,560000.0
5,2.5,2650,1.0,0,1400,1250,1961,564999.9999
3,2.25,1830,1.0,0,1290,540,1986,572000.0001
6,2.75,2630,1.0,0,1650,980,1974,582999.9999
3,2.5,1780,3.0,0,1600,180,2006,586500.0
4,2.5,4060,1.0,4,2150,1910,1977,603500.0
4,3.5,2910,2.0,0,2910,0,2012,610000.0001
4,2.25,2500,1.0,0,1600,900,1978,645999.9999
4,2.5,3290,2.0,0,3290,0,2008,648000.0
3,2.25,2560,2.0,0,2560,0,1986,658587.9998
4,2.5,2770,2.0,0,2770,0,1989,685000.0002
3,2.25,2370,1.0,0,1650,720,1973,745999.9999
4,2.5,2730,2.0,0,2730,0,1986,759999.9999
3,2.0,1990,1.0,0,1130,860,1912,760500.0
4,3.0,4410,2.0,0,3400,1010,2006,765000.0
3,2.25,2430,2.0,0,1810,620,1989,791000.0
4,2.5,2700,2.0,0,2700,0,1994,837500.0
3,3.25,4720,2.0,2,3190,1530,1998,860000.0002
3,1.75,2090,2.0,0,1610,480,1947,865000.0
4,2.75,3790,2.0,0,3790,0,1999,874999.9999
4,2.5,2770,2.0,0,2770,0,1987,907500.0
5,3.5,3280,2.0,0,2440,840,2003,988999.9999
5,2.75,2660,1.0,4,1470,1190,1969,1100000.0
5,3.5,3880,2.0,3,2540,1340,1979,1126000.0
3,1.0,1010,1.0,0,1010,0,1958,189000.0
4,1.5,1920,1.0,0,1370,550,1959,210000.0
2,2.5,1150,2.0,0,1150,0,2004,214100.0
2,1.0,1190,1.0,0,830,360,1941,228999.9999
3,1.0,1130,1.0,0,1130,0,1954,237000.0
4,2.5,2068,2.0,0,2068,0,1976,237227.8571
3,1.0,1150,1.0,0,1150,0,1957,240000.0
3,2.5,1510,1.0,0,1030,480,1976,250000.0
3,2.5,1610,2.0,0,1610,0,1994,255000.0
4,2.75,2330,1.0,0,1800,530,1990,257000.0
4,2.5,2100,2.0,0,2100,0,2006,268500.0001
3,1.0,1690,1.0,0,1020,670,1967,269000.0
3,1.5,1890,1.0,0,1090,800,1957,270000.0001
3,1.0,1500,1.0,0,1500,0,1968,270000.0001
3,3.0,1390,2.0,0,1140,250,2006,275000.0
3,2.0,1750,1.0,0,1350,400,1961,279950.0001
3,2.0,1680,1.0,0,1680,0,1993,289000.0
5,2.5,2490,1.0,0,1490,1000,1989,292000.0
4,2.5,1910,2.0,0,1910,0,2005,297500.0
4,1.75,1560,1.0,0,1560,0,1965,299950.0
3,2.5,1660,2.0,0,1660,0,2009,324500.0
4,2.5,2610,2.0,0,2610,0,2009,335000.0
3,2.0,1170,1.0,0,1170,0,1919,335000.0
4,2.5,2070,2.0,0,2070,0,2004,343000.0
3,2.5,2600,2.0,0,2600,0,2004,355500.0
2,1.0,920,1.0,0,920,0,1914,356000.0
4,2.5,2390,2.0,0,2390,0,1999,359799.9999
3,1.5,1180,1.0,0,800,380,1981,372500.0
3,1.75,960,1.0,0,960,0,1962,375000.0
4,2.75,2420,2.0,0,2420,0,2005,375999.9999
3,2.25,1710,1.0,0,1210,500,1978,385000.0
3,2.0,1463,3.0,0,1463,0,2003,389999.9999
4,3.0,1980,1.0,0,1160,820,1983,395000.0
3,1.75,1460,1.0,0,1460,0,1961,395000.0
4,2.5,2658,2.0,0,2658,0,2014,411605.0001
3,2.0,1330,1.0,0,1330,0,1969,420642.8571
4,2.75,2440,2.0,1,2440,0,1957,425000.0
3,1.75,1980,1.0,1,1090,890,1910,440825.0
4,2.5,2340,2.0,0,2340,0,2008,445000.0
3,2.5,2170,2.0,0,2170,0,2003,449950.0
4,1.0,2000,1.5,0,1250,750,1916,449999.9999
4,1.75,2000,1.0,2,1300,700,1959,453500.0
4,1.75,1670,1.0,0,1670,0,1947,456000.0
3,2.25,1530,2.0,0,1050,480,2014,465000.0
3,1.0,1430,1.0,0,950,480,1945,466500.0
3,2.5,1480,2.0,0,1480,0,1996,466800.0001
4,3.75,2810,2.0,2,2070,740,1994,492000.0001
5,3.0,2440,1.0,0,1450,990,2006,495000.0001
3,3.5,1690,2.0,0,1360,330,2008,499000.0
3,2.5,2520,1.5,0,2520,0,1988,499500.0
3,2.5,2370,2.0,0,2370,0,2001,499950.0001
4,3.25,4160,2.0,0,2760,1400,1973,529999.9998
4,2.25,2210,2.0,0,2210,0,1968,530000.0
4,2.25,2980,1.5,2,2020,960,1935,535000.0
4,2.25,1330,1.5,0,1330,0,1962,540000.0
3,1.75,1700,1.5,0,1700,0,1931,545000.0002
3,2.5,1480,1.0,0,1480,0,1968,547000.0001
4,2.5,2700,2.0,0,2700,0,2007,550000.0001
4,2.75,2020,1.0,0,1420,600,1976,554999.9999
4,2.5,2260,2.0,0,2260,0,2003,560000.0
3,2.75,2390,1.0,0,1360,1030,1977,565000.0001
3,2.5,1640,2.0,0,1640,0,1992,592105.7143
4,1.75,1830,2.0,0,1230,600,1990,610000.0
4,1.75,1660,1.5,0,1660,0,1926,619000.0
4,2.25,2400,1.5,0,1460,940,1929,619999.9999
4,3.75,4610,1.0,0,2500,2110,1980,630000.0
3,1.75,2340,1.0,0,1170,1170,1917,640000.0
3,2.5,2680,1.0,0,1610,1070,1979,652999.9999
3,2.5,2050,2.0,0,2050,0,2011,700000.0
3,1.75,1910,1.0,0,1080,830,1959,700000.0
4,2.75,2420,1.0,0,1530,890,1977,725000.0
3,2.5,2670,2.0,0,2670,0,1987,748999.9999
4,2.75,3110,2.0,0,3110,0,1983,749950.0
4,2.25,2070,1.0,0,1700,370,1967,795000.0
3,3.5,3590,2.0,0,3590,0,1999,798000.0
4,3.5,3500,2.0,0,2500,1000,1994,799000.0
3,3.5,3250,2.0,0,2500,750,2001,874999.9999
5,2.5,2920,2.0,0,2320,600,1906,875000.0
4,2.0,2660,1.5,0,1480,1180,1923,886000.0
5,4.75,5180,2.0,2,4070,1110,2001,1075000.0
6,4.5,3902,3.0,4,2782,1120,1977,1300000.0
4,5.25,4670,2.0,0,4670,0,1989,1415000.0
3,1.0,1840,1.0,0,920,920,1953,185000.0
2,1.0,810,1.0,0,810,0,1948,253500.0
4,2.25,1900,1.0,0,1900,0,1975,270000.0
5,2.5,2690,2.0,0,2690,0,2012,278999.9999
2,1.0,780,1.0,0,780,0,1943,285000.0
3,2.0,1970,1.0,0,1300,670,1967,294700.0
4,2.5,2680,2.0,0,2680,0,1999,299999.9999
3,1.5,1750,1.0,0,1150,600,1954,315000.0
3,2.5,3080,2.0,0,3080,0,1990,315368.6999
3,1.75,1370,1.0,0,1370,0,1983,320000.0
3,1.75,1020,1.5,0,1020,0,1953,360000.0
4,1.0,1550,1.5,0,1550,0,1954,385200.0
3,1.0,1560,1.0,0,1560,0,1953,387500.0
2,1.5,1490,1.0,0,930,560,1956,389250.0
3,2.5,2700,1.0,3,1350,1350,1959,402000.0
2,2.0,1405,2.0,0,1140,265,2007,405000.0
4,2.0,1880,2.0,0,1880,0,1978,407193.0001
3,1.75,1910,1.0,0,1340,570,1977,415000.0
4,2.25,2070,2.0,0,2070,0,1977,417985.7143
3,1.75,1470,1.0,3,1070,400,1939,432000.0
2,1.0,1260,1.5,0,1260,0,1926,435000.0
4,2.0,1470,1.0,0,1470,0,1965,444999.9999
3,2.5,1480,2.0,0,1480,0,2005,450000.0
2,1.75,1740,1.0,0,990,750,1946,452000.0
4,1.75,2050,1.0,0,1250,800,1959,455000.0001
4,2.25,1740,1.0,0,1170,570,1958,455000.0001
3,2.5,2030,2.0,0,1720,310,2001,471000.0001
4,1.0,1720,1.5,0,1720,0,1904,500000.0
3,1.75,1480,1.0,0,1480,0,1974,510000.0
4,1.5,1320,1.0,0,1320,0,1954,510000.0
5,2.75,2440,1.0,0,1240,1200,1972,525000.0001
3,1.5,1730,2.0,0,1730,0,1983,535500.0001
3,2.0,2260,1.0,0,1780,480,1985,539000.0
4,2.5,2040,2.0,0,2040,0,1990,545000.0
3,1.5,1900,1.5,0,1640,260,1926,550000.0
3,2.5,2400,2.0,0,2400,0,1993,570000.0
4,2.5,2430,2.0,0,2430,0,2008,585000.0
4,2.5,2630,2.0,0,2630,0,2008,589499.9999
4,2.5,1990,2.0,0,1680,310,2005,594999.9999
4,2.5,2560,2.0,0,2560,0,2001,599999.9999
4,2.5,2840,2.0,0,2840,0,1990,649999.9999
3,1.75,1980,1.5,0,1140,840,1926,660000.0
3,2.25,2270,1.0,0,1820,450,1975,679999.9999
3,2.5,2550,2.0,0,2550,0,1990,715000.0001
4,2.75,3010,2.0,0,3010,0,2014,723243.75
4,2.5,2820,2.0,0,2050,770,2013,735000.0001
4,3.0,2720,2.0,0,1800,920,1919,739000.0
3,2.5,2670,2.0,0,2670,0,1986,744000.0
5,2.5,4600,1.0,3,2300,2300,1956,805000.0
4,2.0,2230,1.5,0,2230,0,1959,809949.9999
2,2.0,2280,1.0,0,2280,0,2002,835000.0
5,2.75,3030,2.0,0,3030,0,2014,837219.0001
4,3.0,3240,2.0,0,3240,0,2013,895000.0
4,2.75,2880,1.5,0,1710,1170,1928,919999.9999
4,2.5,4150,2.0,0,4150,0,2014,969989.9999
4,3.25,3450,2.0,3,2430,1020,1960,1035000.0
5,2.75,4400,1.0,3,2250,2150,1963,1120000.0
4,3.5,3010,2.0,0,2370,640,1999,1280000.0
4,4.0,4270,2.0,3,3180,1090,2004,1300000.0
4,3.5,4280,2.0,0,4280,0,2005,1337044.2
4,2.5,3070,2.0,0,3070,0,2006,462000.0001
3,3.0,1730,3.0,0,1730,0,1985,490000.0001
4,2.5,2460,2.0,0,2460,0,1998,568500.0
6,2.5,3820,1.0,0,2040,1780,1974,611000.0
4,2.5,1811,2.0,0,1811,0,2007,259999.9999
2,1.0,1440,1.0,0,960,480,1915,445000.0
3,1.0,1300,1.5,0,1300,0,1927,455000.0
4,2.25,2450,2.0,0,2450,0,1976,510000.0
3,2.75,3400,2.0,2,2470,930,2009,529999.9999
5,3.0,2870,2.0,0,2090,780,2007,540000.0
4,2.5,1780,2.0,0,1780,0,1994,540000.0
3,2.5,2300,2.0,0,2300,0,2001,567499.9999
4,2.25,2370,2.0,0,2370,0,1979,684680.0
4,1.75,1980,1.0,0,1480,500,1978,213000.0001
3,1.5,1150,1.0,0,1150,0,1963,213400.0
4,1.75,1300,1.0,0,1300,0,1969,229950.0001
3,1.0,1330,1.0,0,1330,0,1948,234999.0
3,1.0,1590,1.5,0,1590,0,1944,235000.0
3,1.75,1330,1.0,0,1330,0,1998,236000.0
4,1.0,1910,1.5,0,1910,0,1934,240000.0001
5,1.5,2520,1.5,0,1510,1010,1928,250000.0
3,2.25,2210,2.0,0,2210,0,1969,250250.0
2,1.0,1200,1.0,2,1200,0,1917,255000.0
4,2.0,2030,1.0,0,2030,0,1976,259950.0001
2,1.0,1000,1.0,0,1000,0,1960,264999.9999
4,2.75,1990,1.0,0,1270,720,1999,270000.0
3,2.25,1680,2.0,0,1680,0,1987,285000.0
3,1.5,1860,1.0,0,1200,660,1963,288350.0
4,3.0,2390,2.0,0,2390,0,1974,290000.0
4,2.5,1980,2.0,0,1980,0,2003,307550.0
3,2.5,1480,2.0,0,1150,330,2010,315000.0
3,2.0,1350,1.0,0,1350,0,1986,325000.0
4,1.75,1920,1.0,0,1500,420,1975,341000.0
2,1.5,1340,2.0,0,1120,220,2008,345000.0
3,2.5,1210,3.0,0,1210,0,2008,345000.0
3,1.75,1240,1.0,0,1240,0,1978,347000.0
2,1.75,1060,2.0,0,960,100,2008,352750.0
3,3.0,2500,2.0,0,2500,0,1997,364899.9999
3,2.5,1800,2.0,0,1800,0,2011,365000.0
4,2.75,2190,2.0,0,2190,0,1993,367300.0001
3,1.75,1710,1.0,0,1710,0,1958,368000.0
4,1.5,2020,1.0,0,2020,0,1960,379000.0
3,1.75,1230,1.0,0,1230,0,1987,385000.0
4,1.75,2700,1.5,0,2700,0,1968,390000.0
3,2.5,1720,2.0,0,1240,480,2004,398000.0
4,3.5,2370,2.5,0,2370,0,2013,400000.0001
2,1.0,1140,1.0,0,1140,0,1942,400000.0
3,2.5,1960,2.0,0,1960,0,2006,410000.0
3,1.0,1410,1.0,0,910,500,1956,410000.0
3,2.0,1310,1.0,0,780,530,1986,428000.0
3,2.25,1890,1.0,0,1230,660,1973,434999.9999
3,1.75,2240,1.0,0,1120,1120,1948,440000.0
4,2.5,2170,2.0,0,2170,0,1992,442500.0
3,1.75,1640,1.0,0,1110,530,1940,450000.0
4,2.5,2330,2.0,0,2330,0,1998,470999.9999
4,2.75,1980,1.0,0,1980,0,1952,475000.0
4,1.75,2220,2.0,3,2220,0,1964,480000.0
3,3.5,1500,2.0,0,1240,260,2004,489000.0
4,1.75,2240,1.5,0,2240,0,1965,500000.0
3,1.75,1300,1.0,0,1300,0,1963,502000.0
3,3.0,2470,2.0,0,2470,0,1980,525000.0
3,2.5,1900,2.0,0,1900,0,2005,536000.0
3,2.25,2190,1.0,1,1240,950,1963,539949.9999
4,2.5,2700,1.0,0,1440,1260,1968,549999.9999
3,2.5,2260,2.0,0,2260,0,2005,550000.0
2,2.5,1380,3.0,0,1380,0,2006,552000.0
3,1.75,1760,1.0,0,1760,0,1977,554000.0
3,1.5,2070,1.0,0,1140,930,1948,559000.0
4,2.5,2800,2.0,0,2800,0,2001,563499.9999
3,1.75,2050,1.0,0,1070,980,1977,568000.0
2,2.0,1870,1.0,0,1870,0,2003,579000.0
4,3.5,3730,2.0,2,2440,1290,1991,599950.0
3,2.5,2630,2.0,0,2630,0,2004,600000.0001
3,2.5,2670,2.0,3,2670,0,1981,605000.0001
4,2.5,3190,2.0,0,3190,0,2006,609899.9999
3,2.5,2590,2.0,0,2590,0,2004,620000.0001
3,1.75,2210,1.0,0,1390,820,1958,625000.0
3,2.5,2140,2.0,0,2140,0,1991,639999.9999
4,2.5,2380,2.0,0,2380,0,1992,647999.9999
4,2.5,2350,2.0,0,2350,0,1994,649950.0001
4,3.0,3150,2.0,0,3150,0,2000,700000.0001
4,2.5,2800,2.0,0,2800,0,1999,739000.0007
4,2.5,2610,2.0,0,2610,0,1988,743699.9999
4,3.25,2050,2.0,0,1370,680,1987,750000.0
4,2.5,2030,1.5,0,1630,400,1926,831000.0001
3,2.5,2630,1.0,0,1580,1050,1967,852500.0
4,2.25,3160,1.0,0,3160,0,1981,965000.0001
4,2.5,2730,1.5,0,2230,500,1909,979999.9999
3,2.5,2850,1.0,0,1730,1120,1954,1150000.0
4,2.5,2740,2.0,0,2740,0,1984,1225000.0
4,2.5,4250,2.0,2,3260,990,1972,1339000.0
4,3.25,3300,2.0,0,3300,0,1985,1350000.0
5,3.5,4220,1.0,0,2110,2110,1958,1635000.0
4,3.25,4130,2.0,0,4130,0,1978,1900000.0
4,1.0,1120,1.0,0,860,260,1939,99999.99997
4,1.0,1200,1.5,0,1200,0,1944,135333.3333
3,1.0,1010,1.0,0,1010,0,1959,149500.0
3,1.0,970,1.0,0,970,0,1965,165000.0
3,1.75,1330,1.0,0,1330,0,1973,183000.0
3,1.0,920,1.0,0,920,0,1962,199500.0
3,1.0,970,1.0,0,970,0,1967,219900.0
3,1.75,1760,1.0,0,920,840,1979,225000.0
3,1.75,1590,1.0,0,1130,460,1984,250000.0
3,2.0,1320,1.0,0,1320,0,1975,251750.0
3,1.75,2040,1.0,0,1020,1020,1962,253000.0
2,1.0,1380,1.0,0,870,510,1943,268000.0
3,2.5,1560,2.0,0,1560,0,2003,269000.0
4,2.25,1940,2.0,0,1940,0,1990,278499.9999
2,2.0,1651,1.0,0,1651,0,1946,285000.0
4,2.5,2009,2.0,0,2009,0,2014,303210.0
2,1.5,1010,2.0,0,1010,0,1981,306888.0
4,1.0,1150,1.5,0,1150,0,1947,307000.0
3,2.5,1780,1.0,0,1230,550,1990,310000.0
4,1.0,1740,1.5,0,1740,0,1965,310000.0001
3,1.75,1420,1.0,0,1100,320,1984,310000.0
4,2.5,1930,2.0,0,1930,0,1992,315000.0
2,1.0,1740,1.0,0,950,790,1924,315000.0
3,1.75,2430,1.0,0,1410,1020,1978,335000.0
3,1.75,1540,1.0,0,920,620,1955,345000.0
2,0.75,1392,1.5,0,1392,0,1978,350000.0001
3,1.75,1890,2.0,0,1890,0,1952,359950.0
4,2.0,1630,1.0,0,1630,0,1968,360000.0
3,1.75,1520,1.0,0,1520,0,1976,366000.0
4,2.5,1960,2.0,0,1960,0,2002,369990.0
4,2.5,2210,2.0,0,2210,0,1999,374999.9999
3,1.5,1530,1.0,0,1530,0,1975,375500.0
4,1.5,1680,1.0,0,1130,550,1959,380000.0
4,1.75,1720,1.0,0,860,860,1971,385000.0
4,2.75,1940,2.0,0,1940,0,1990,392000.0
4,2.5,2530,1.0,0,1440,1090,1978,400000.0
2,1.0,1100,1.0,0,1100,0,1926,403000.0
3,2.5,2090,2.0,0,2090,0,2000,415000.0
4,1.0,1390,1.5,0,1390,0,1941,417500.0
3,2.5,2340,2.0,0,2340,0,1995,426089.9999
3,3.25,1410,3.0,0,1410,0,2005,429000.0
3,1.5,2010,1.0,0,1570,440,1951,429950.0
3,1.75,1870,1.0,0,1270,600,1959,433000.0
5,2.25,1970,1.0,0,1450,520,1986,435000.0
3,1.5,1290,3.0,0,1290,0,2000,440000.0
2,1.0,1470,1.0,0,1020,450,1941,458663.8888
3,1.75,2290,1.0,0,1620,670,1965,469999.9999
5,2.5,2732,1.0,2,1870,862,1975,479999.9999
4,1.75,2320,1.0,0,1140,1180,1910,480000.0
4,2.0,1210,1.0,0,1210,0,1955,483300.0
4,2.5,3020,2.0,0,3020,0,1994,489999.9999
3,2.0,2220,2.0,0,1640,580,1980,490000.0001
3,2.5,1800,2.0,0,1800,0,1996,515000.0
3,2.0,2110,1.0,0,1080,1030,1919,516200.0001
5,2.75,2880,2.0,0,2880,0,2006,525000.0
4,2.75,2790,2.0,0,2790,0,2013,533112.0001
3,2.0,2180,1.5,2,1680,500,1930,555000.0
4,2.0,2180,1.0,0,1020,1160,1900,558000.0
4,1.75,2440,1.0,0,1340,1100,1954,566000.0
5,3.0,3670,1.0,0,2060,1610,1952,569000.0
4,2.0,2750,1.5,0,2250,500,1916,571000.0
4,4.5,3870,2.0,0,2530,1340,2001,589900.0001
4,2.75,2490,1.0,0,1400,1090,1983,608000.0001
4,2.25,2560,2.0,0,2560,0,1973,650000.0001
3,1.75,2050,1.0,0,1460,590,1962,655275.0
3,2.5,2510,2.0,0,2510,0,1996,658999.9999
3,1.75,1820,1.0,0,1620,200,1957,659500.0001
3,1.75,1760,1.0,0,1460,300,1960,680000.0
3,2.5,2550,2.0,0,2550,0,2001,694999.9999
4,3.5,3510,2.0,0,3510,0,2001,695000.0
3,2.75,2540,2.0,0,2540,0,2005,694999.9999
5,2.75,3100,2.0,2,3100,0,1950,700000.0001
3,2.0,2080,1.0,0,1160,920,1954,699999.9999
3,3.5,2440,2.0,0,1990,450,2000,710000.0001
3,2.5,3000,2.0,0,3000,0,1995,740000.0001
4,3.25,3490,2.0,0,3490,0,2006,745000.0
5,3.25,2750,2.0,1,2150,600,1937,750000.0001
4,2.5,3700,1.0,4,2620,1080,1988,812650.0
4,2.5,3340,2.0,1,2470,870,1998,870000.0
5,2.5,2550,1.0,0,1610,940,1953,895000.0
4,2.5,2580,2.0,0,2580,0,2013,899899.9999
6,3.75,2930,2.0,3,2930,0,2013,915000.0
5,4.0,3760,2.0,0,3760,0,1983,1025000.0
5,3.25,3230,2.0,0,2480,750,2014,1059500.0
3,3.0,2940,2.0,0,2230,710,1988,1070000.0
5,3.75,3630,1.5,0,2470,1160,2004,1180000.0
4,2.5,3040,2.0,0,3040,0,2001,1230000.0
5,3.25,5270,2.0,1,4010,1260,1977,1795000.0
1,1.0,620,1.0,0,620,0,1939,148000.0
2,1.0,700,1.0,0,700,0,1953,200000.0
3,1.75,1570,1.0,0,1310,260,1977,214950.0
3,1.0,1050,1.0,0,1050,0,1942,220000.0
3,2.0,1640,1.5,0,1640,0,1910,234000.0
3,1.5,1360,1.5,0,1360,0,1984,240000.0
5,1.5,1510,1.0,0,1510,0,1959,248000.0
2,1.5,982,2.0,0,806,176,2006,250000.0
3,1.5,1160,1.0,0,1160,0,1962,262500.0
2,1.0,1350,1.0,2,1350,0,1952,276900.0
3,2.5,1860,2.0,0,1860,0,1989,279999.9999
3,2.5,1870,2.0,0,1870,0,2005,285000.0001
3,1.75,1520,1.0,0,1520,0,1968,290000.0001
2,1.0,860,1.0,0,860,0,1931,290300.0
4,2.75,2414,2.0,0,2414,0,2006,292000.0
5,3.5,2100,2.0,0,1410,690,1999,295000.0
3,2.5,2250,2.0,0,2250,0,1994,308900.0
3,1.0,1160,1.0,0,1160,0,1952,317000.0
3,1.75,1790,1.0,0,1130,660,1978,324999.9998
3,2.5,2456,2.0,0,2456,0,2012,329950.0
3,2.5,2210,2.0,0,2210,0,1989,330000.0001
2,1.0,720,1.0,0,720,0,1942,333000.0
4,2.25,2030,1.0,0,1230,800,1963,334999.9999
3,2.5,1430,3.0,0,1430,0,2002,348999.9999
3,3.25,1460,2.0,0,1130,330,2006,350000.0
3,1.75,1170,1.0,0,1170,0,1962,352499.9999
3,1.0,940,1.0,0,940,0,1965,354000.0
3,1.0,890,1.0,0,890,0,1951,371000.0
3,2.0,1370,1.0,0,1370,0,1964,371500.0
3,1.5,1460,1.0,0,1460,0,1954,381000.0
3,1.5,1270,2.0,0,1080,190,2004,386000.0
3,2.0,1640,1.0,0,1640,0,1948,405000.0
4,2.5,2550,2.0,0,2550,0,2009,415000.0001
4,1.0,1860,1.5,0,1860,0,1901,427000.0
3,2.5,1420,3.0,0,1420,0,2004,434999.9999
4,2.5,2300,1.0,0,2300,0,1955,450000.0
4,2.5,3170,2.0,2,3170,0,2001,455000.0
3,2.0,2060,1.0,0,1030,1030,1929,460000.0
4,2.5,2180,2.0,0,2180,0,1989,464000.0
4,2.5,2090,1.0,0,1320,770,1965,465000.0001
4,1.75,1470,1.0,0,980,490,1955,465000.0
3,2.25,1630,2.0,0,1630,0,2005,474999.9999
6,5.0,3440,2.0,0,3280,160,2007,495000.0001
3,1.75,1720,1.0,1,1220,500,1986,513999.9999
3,2.5,3370,2.0,0,3200,170,1951,515000.0001
4,3.5,2550,2.0,0,2550,0,2007,516000.0001
3,1.75,1730,1.0,0,1400,330,1980,522000.0
2,1.75,1640,1.0,0,840,800,1921,527000.0
3,1.75,1550,1.0,0,1050,500,1927,530000.0
5,2.25,2520,2.0,0,2520,0,1978,534999.9999
3,2.5,2180,1.0,0,1850,330,1979,545000.0
3,3.5,1650,3.0,0,1650,0,2010,547500.0
3,2.5,1990,2.0,0,1990,0,2004,560200.0
3,2.5,2600,2.0,0,2600,0,1988,571000.0
4,2.75,2240,1.5,0,2240,0,1976,580379.0001
4,2.0,1680,1.0,0,980,700,1950,587999.9999
4,2.0,2090,1.5,0,1790,300,1927,619400.0
4,2.75,4140,2.0,0,4140,0,2002,657500.0
6,3.0,4250,2.5,0,3020,1230,1902,664999.9998
3,2.75,2500,1.0,0,1390,1110,1948,700000.0
4,1.75,2460,1.5,0,1450,1010,1909,734999.9999
4,2.75,2490,2.0,2,1490,1000,1979,740000.0
4,2.5,2810,2.0,0,2810,0,1997,742000.0
3,1.75,2430,1.0,1,1230,1200,1949,762400.0
3,3.5,4500,2.0,0,4500,0,2004,785000.0
3,1.5,2210,1.5,0,2210,0,1916,799000.0
4,3.75,2690,2.0,3,2120,570,1909,799999.9999
4,2.5,3280,2.0,0,3280,0,2001,809949.9999
4,2.75,3370,1.0,3,1920,1450,1948,812999.9999
3,2.5,2070,1.5,0,1270,800,1910,850830.0
4,2.5,3320,2.0,0,2650,670,1977,852600.0001
4,2.5,3470,2.0,0,3470,0,1995,875000.0
5,3.0,2510,1.5,3,1590,920,1925,880999.9999
4,2.5,3760,2.0,0,3760,0,1987,1010000.0
5,3.5,4210,2.0,3,4210,0,1995,1365000.0
5,6.25,8670,2.0,4,6120,2550,1965,2888000.0
2,1.0,820,1.0,0,820,0,1965,173000.0
4,1.75,1200,1.0,0,1200,0,1968,210000.0
4,1.5,1130,1.0,0,1130,0,1970,210000.0
2,1.0,910,1.0,0,910,0,1957,223000.0
2,1.0,1100,1.0,0,1100,0,1947,229629.5
3,1.75,1840,1.0,0,1500,340,1985,235000.0
4,2.5,1770,2.0,0,1770,0,2003,247999.9999
4,1.5,1490,2.0,0,1490,0,1966,259000.0
4,2.5,2210,1.0,0,1490,720,1990,294000.0
3,2.5,1970,2.0,0,1970,0,1988,299995.0
3,3.25,1470,2.0,0,1180,290,2008,300000.0001
4,2.5,2490,2.0,0,2490,0,2001,306000.0
5,3.0,1880,1.0,0,1100,780,1997,310000.0
2,1.5,1070,2.0,0,1070,0,1999,312500.0
3,2.5,1880,2.0,0,1880,0,1993,315000.0
2,1.0,970,1.0,0,970,0,1908,315000.0
4,2.5,1910,1.0,0,1910,0,1963,333000.0
2,2.25,1170,2.0,0,1170,0,2009,336750.0
3,2.0,2080,1.0,0,2080,0,2002,342499.9999
3,1.0,1060,1.0,0,1060,0,1966,349950.0
4,2.25,2300,1.5,0,1340,960,1904,349999.9999
3,3.25,1651,2.0,0,1341,310,2008,363000.0001
2,1.0,1220,1.0,0,1220,0,1947,370000.0001
3,1.75,1800,1.0,0,900,900,1950,381000.0
3,1.75,1590,1.5,0,970,620,1938,387884.6154
3,1.0,1180,1.0,0,1180,0,1948,397990.0
3,1.0,1330,1.0,0,900,430,1984,405000.0
4,1.75,1890,1.0,0,1110,780,1947,430000.0
3,3.5,1240,2.0,0,1000,240,2008,435500.0
5,3.5,3690,2.0,0,2540,1150,2006,437500.0
3,1.0,1710,1.5,0,1200,510,1926,440000.0
3,2.75,1560,1.0,0,1030,530,1972,440000.0001
5,1.75,2460,1.5,0,1340,1120,1911,445000.0
2,1.5,1630,1.0,0,890,740,1940,448000.0
5,2.0,1940,1.5,0,1940,0,1957,465249.9999
3,2.5,1250,3.0,2,1250,0,2005,480000.0001
4,2.5,2470,2.0,0,2470,0,1989,485000.0001
4,2.25,2640,1.0,0,2640,0,1986,489949.9999
4,2.5,2140,2.0,0,2140,0,2003,495000.0
3,2.0,1769,1.0,0,1769,0,1955,494999.9999
5,2.75,2990,2.0,0,2990,0,1996,498500.0001
3,1.75,1970,1.0,3,1370,600,1976,500999.9999
3,1.75,1600,1.0,0,1600,0,1967,509999.9999
3,2.5,2120,2.0,0,2120,0,1988,531000.0
3,1.0,1510,1.5,0,1510,0,1909,545000.0
4,1.75,1880,1.5,0,1090,790,1944,560000.0
3,2.25,1710,2.0,0,1710,0,2004,561000.0001
2,1.0,1510,1.5,0,1310,200,1935,575000.0
4,2.5,3140,1.0,2,1770,1370,1966,578000.0
5,2.0,2060,2.0,0,2060,0,1903,579999.9999
3,2.5,1910,2.5,0,1530,380,2007,585000.0
4,1.75,1870,2.0,0,1200,670,1937,594000.0
5,2.75,2820,1.0,0,1450,1370,1967,598999.9999
4,2.25,2180,2.0,0,2180,0,1984,610749.9999
2,1.0,1430,1.5,0,1300,130,1929,620000.0001
3,2.5,2480,2.0,0,2480,0,2000,641633.3332
4,2.0,2710,1.0,0,1460,1250,1919,656500.0
3,3.0,2340,2.0,0,2160,180,1925,660000.0
3,2.5,2050,1.0,3,1730,320,1956,670000.0
3,2.0,2460,1.0,2,1370,1090,1952,678500.0
3,2.5,2570,2.5,0,2570,0,2007,680000.0001
4,2.5,2683,2.0,0,2683,0,1987,681965.7811
4,2.5,3280,2.0,0,3280,0,1996,699000.0001
3,2.75,1900,1.0,0,1410,490,1942,706000.0
3,1.75,2110,1.0,0,2110,0,1961,742999.9999
3,3.5,3950,1.5,0,2460,1490,1989,784000.0006
4,2.5,3010,2.0,0,3010,0,2005,789500.0001
4,3.25,2420,1.5,0,1870,550,1911,789999.9999
3,2.0,2420,1.0,1,1500,920,1979,795000.0
3,3.0,2790,2.0,4,1600,1190,1977,835000.0002
4,3.25,3960,2.0,0,3960,0,2005,860000.0002
4,2.25,2460,1.0,0,2460,0,1957,900000.0001
4,2.5,2370,2.0,0,2370,0,2003,1034500.0
4,2.5,3270,2.0,0,3270,0,1989,1070000.0
0,0.0,3064,3.5,2,3064,0,1990,1095000.0
4,2.5,3200,1.5,1,1860,1340,1948,1184000.0
4,2.5,5730,2.0,4,4280,1450,1991,1228000.0
5,4.0,4410,2.0,0,4410,0,2006,1240000.0
4,3.75,4030,2.0,0,4030,0,2006,1485000.0
3,1.0,1270,1.5,0,1270,0,1944,153000.0
3,1.0,1290,1.0,0,1290,0,1976,205000.0
3,1.0,1340,1.0,0,1340,0,1978,206135.0
2,1.75,1440,1.0,0,1440,0,1978,210000.0
2,1.0,710,1.0,0,710,0,1943,215000.0
2,1.0,930,1.0,0,930,0,1986,230000.0
3,1.75,1900,1.0,0,950,950,1980,235000.0
3,2.25,1400,2.0,0,1400,0,2012,250000.0
4,2.5,1930,1.0,0,1120,810,1981,250600.0
4,1.75,1900,1.0,0,1900,0,1958,265000.0
3,1.75,1840,1.0,0,920,920,1905,285000.0
3,1.75,1180,1.0,0,1180,0,1962,299000.0
4,2.5,2700,1.0,0,1560,1140,1966,300000.0
3,2.0,2020,1.0,0,1220,800,1957,300000.0
3,1.0,1280,1.5,0,1280,0,1947,304000.0
3,1.5,1210,1.0,0,610,600,1983,305000.0001
4,2.5,1880,2.0,0,1880,0,2000,324900.0
3,2.5,2070,2.0,0,2070,0,1997,325000.0
3,2.5,1070,2.0,0,720,350,2005,330000.0
2,1.5,1800,1.0,0,1240,560,1987,345000.0
3,1.75,1820,1.0,0,1230,590,1976,349999.9999
3,1.5,1650,1.0,0,1100,550,1961,369500.0
4,2.5,2220,2.0,0,2220,0,2001,370000.0001
3,2.25,1410,2.0,0,1290,120,2005,379500.0
4,2.5,2540,2.0,0,1870,670,2000,380000.0
3,2.25,1920,1.0,0,1060,860,1921,385000.0
4,2.5,2050,2.0,0,2050,0,2006,385000.0
4,2.5,1750,2.0,0,1750,0,2009,415499.9999
4,2.5,2690,2.0,0,2690,0,1993,418999.9999
3,2.0,1910,1.5,0,1910,0,1971,430000.0
3,1.75,1500,1.0,0,1500,0,1997,434999.9999
4,2.25,2010,1.0,0,1220,790,1974,440000.0
4,2.25,2630,2.0,0,2630,0,1979,454000.0001
3,1.75,1850,1.0,2,1100,750,1919,459949.9999
3,2.25,1580,1.0,0,1200,380,1981,475000.0
3,2.5,1580,2.0,0,1580,0,1985,485000.0
3,1.75,1760,1.0,0,1230,530,1967,497333.3333
3,1.0,1830,1.5,0,1430,400,1926,499950.0
4,2.75,2020,1.0,0,1010,1010,1958,513000.0
3,1.0,1540,1.5,0,1200,340,1926,530099.9999
5,3.0,3610,2.0,0,3610,0,2003,540000.0
3,1.75,1640,1.0,0,1090,550,1948,556000.0
3,3.0,1384,2.0,0,1144,240,2006,575000.0
3,2.5,2040,2.0,0,2040,0,1992,580000.0
3,1.0,1870,1.5,0,1580,290,1927,584999.9999
4,3.0,2440,2.0,0,2440,0,1961,588999.9999
3,2.0,2250,1.0,0,1250,1000,1925,589000.0
4,2.5,2010,2.0,0,2010,0,1989,590000.0
3,1.75,2350,1.0,0,1800,550,1978,614999.9999
5,2.75,3320,2.0,0,2190,1130,1975,622500.0
4,2.5,2790,2.0,0,2790,0,1989,665000.0001
4,2.75,3650,1.5,0,3650,0,1978,697000.0
3,2.0,2910,2.0,0,1920,990,1900,718500.0001
5,2.5,3210,1.0,0,1830,1380,1968,724999.9999
3,2.5,2300,1.5,0,1510,790,1930,738190.8572
4,2.5,2420,1.0,4,1700,720,1958,760000.0
4,2.0,3140,1.0,1,1940,1200,1939,775000.0001
4,3.5,3200,2.0,0,2670,530,2007,795000.0
3,2.5,2860,2.0,0,2860,0,2000,798999.9999
3,1.75,1980,1.0,2,1320,660,1952,810000.0
5,3.5,2320,2.0,0,1720,600,1926,822500.0
4,2.5,4120,2.0,0,4120,0,1997,862999.9999
4,2.5,3670,2.0,0,3670,0,1999,883000.0002
4,2.25,2770,2.0,0,2770,0,1974,890000.0002
5,2.5,2350,2.0,0,2350,0,1993,909999.9999
4,2.5,3770,2.0,0,3770,0,1989,949999.9998
5,2.75,3100,1.0,2,1660,1440,1973,975000.0
4,2.5,2750,2.0,0,1960,790,1905,1030000.0
5,1.5,2540,2.0,3,2340,200,1954,1120000.0
5,2.25,4200,2.5,0,2910,1290,1906,1335000.0
3,2.5,4310,1.5,4,2510,1800,1982,1735000.0
3,1.75,1430,1.0,0,1430,0,1950,330000.0001
3,2.0,1510,1.0,0,1070,440,1972,397500.0
2,1.0,1980,1.0,0,1090,890,1923,496751.9999
4,2.75,2360,2.0,0,2360,0,2008,525000.0
3,2.5,1930,2.0,0,1930,0,2005,530000.0
4,2.75,2450,2.0,2,2450,0,2010,735000.0
5,2.75,2920,1.0,0,1660,1260,1968,850000.0001
4,2.5,2960,2.0,0,2960,0,1985,883000.0
3,2.5,1890,2.0,0,1730,160,2002,269950.0
3,1.0,1110,1.0,0,1110,0,1957,416000.0
5,3.0,2430,1.0,0,1370,1060,1957,506000.0
3,2.0,1900,1.0,0,950,950,1940,520500.0
3,1.75,2140,1.0,0,1290,850,1953,650000.0
4,2.5,2700,2.0,0,2700,0,1990,652500.0
3,1.5,1230,1.0,0,1230,0,1949,150000.0
2,1.0,760,1.5,0,760,0,1947,163785.7143
3,1.5,1220,1.0,0,1220,0,1973,175000.0
3,1.75,1070,1.0,0,1070,0,1957,183000.0
4,2.5,2240,1.0,0,1370,870,1988,220000.0
3,2.0,1410,1.0,0,1410,0,1940,220000.0
3,1.75,1400,1.0,0,1400,0,1957,230000.0
2,1.5,880,2.0,0,880,0,1999,235000.0
2,1.0,1200,1.0,0,980,220,1943,245000.0
3,1.0,1000,1.0,0,1000,0,1969,265000.0
3,1.0,1100,1.0,0,1100,0,1957,277000.0
3,2.5,1880,2.0,0,1880,0,2009,284000.0001
4,1.75,1960,1.0,0,1960,0,1967,285499.9999
3,1.75,1770,1.0,0,1030,740,1960,295000.0
5,3.0,1940,1.0,0,1200,740,2007,300000.0
4,2.0,1810,1.0,0,1110,700,1967,304000.0
3,1.75,1150,1.0,0,1150,0,1979,309212.0
3,2.25,1200,3.0,0,1200,0,2005,320000.0
1,1.0,960,1.0,0,760,200,1908,332000.0
3,1.5,2040,1.0,0,1340,700,1957,334999.9999
3,2.5,1212,3.0,0,1212,0,2004,340000.0
4,1.75,1580,1.0,0,1130,450,1947,351250.0
4,2.25,1760,2.0,0,1760,0,1987,353500.0
2,1.75,1210,2.0,0,1210,0,2014,357185.9999
3,2.0,1530,1.0,0,1530,0,1977,371024.9999
3,1.0,1770,1.5,0,1140,630,1926,373000.0
4,2.0,2400,2.0,0,2400,0,1913,375000.0
4,2.0,1240,1.0,0,1040,200,1908,375000.0
5,2.5,2760,1.0,0,1600,1160,1960,377999.9999
4,2.5,2960,2.0,0,2960,0,2006,385000.0
3,2.0,1590,2.0,0,1590,0,2000,385000.0
4,1.75,1690,1.0,0,870,820,1984,384999.9999
2,1.0,830,1.0,3,830,0,1928,385000.0
4,2.0,1580,1.0,0,1580,0,1953,410000.0
4,2.0,1800,1.0,0,1000,800,1923,414999.9999
4,3.0,2360,1.0,2,1460,900,1960,418000.0
4,1.5,1220,1.0,0,1220,0,1965,418000.0
5,2.5,2340,2.0,0,2340,0,2009,429000.0001
3,2.0,1980,3.0,0,1980,0,2007,435000.0001
3,2.5,2300,2.0,0,2300,0,2003,435000.0
3,1.75,1890,1.5,3,1890,0,1976,444999.9998
6,2.25,3550,1.0,0,2960,590,1948,449999.9999
2,1.5,1310,1.5,0,1310,0,1970,455000.0
3,1.75,1550,1.0,0,860,690,1949,460000.0
3,2.25,2670,1.0,0,1640,1030,1966,465000.0001
3,2.5,1350,2.0,0,1120,230,2007,468500.0
3,1.5,1760,1.0,0,1160,600,1958,470000.0
3,1.5,1510,1.0,0,1510,0,1956,470000.0001
5,2.5,2570,2.0,0,2570,0,2006,492499.9999
3,1.75,1750,1.0,0,1470,280,1968,498999.9999
4,2.75,2280,1.0,0,2280,0,1960,500000.0
3,1.75,1540,1.0,0,770,770,1947,500000.0
4,2.5,1740,1.0,0,1220,520,1976,518000.0001
3,2.25,1420,3.0,0,1420,0,2006,523950.0
4,2.5,2050,2.0,0,2050,0,1988,530000.0
3,2.5,1700,2.0,0,1700,0,2005,534500.0
4,2.5,2650,2.0,0,2650,0,2014,542525.0001
3,2.5,1940,1.0,2,1440,500,1975,545000.0
4,2.25,2170,2.0,0,2170,0,1987,566000.0001
4,2.5,2120,2.0,0,2120,0,1985,575000.0
4,2.5,2440,2.0,0,2440,0,2002,576000.0
5,2.5,2640,2.0,0,2640,0,2003,632500.0
3,2.5,2110,2.0,0,2110,0,2005,638000.0
4,2.75,2610,3.0,0,1910,700,1910,650000.0001
6,1.75,1840,1.0,0,1060,780,1900,660000.0001
3,1.5,1720,2.0,0,1720,0,1907,666999.9999
4,2.75,2500,2.0,0,2500,0,2010,680000.0
4,3.5,2840,3.0,0,2840,0,2008,685000.0
2,1.75,1600,1.0,0,850,750,1918,689999.9999
4,3.5,2690,2.0,0,2690,0,2002,699850.0001
4,3.25,3430,2.0,0,3430,0,2014,749995.0001
3,2.5,3100,2.0,0,3100,0,2002,759950.0
3,1.75,1990,1.0,0,1100,890,1939,763101.0
3,2.75,2670,1.0,0,1720,950,2013,798800.0
4,2.5,2810,1.0,0,1710,1100,1973,825000.0001
4,1.5,1890,1.5,0,1890,0,1919,825000.0
4,3.5,4140,2.0,0,3160,980,2003,849999.9999
4,3.25,3450,2.0,0,3450,0,2014,852880.0
4,2.5,3190,2.0,0,3190,0,1990,861999.9999
4,3.5,3290,2.0,1,2360,930,2006,899949.9999
4,2.5,3030,2.0,0,3030,0,2003,902000.0
4,1.5,2220,1.0,0,1490,730,1954,920999.9999
4,3.5,3280,2.0,0,3280,0,2007,963000.0001
4,2.75,2800,2.0,0,2800,0,1992,998999.9999
4,4.0,3530,2.0,0,2630,900,1958,1095000.0
4,1.0,1920,1.0,0,1220,700,1966,170000.0
3,1.0,1140,1.0,0,1140,0,1943,171224.8
3,1.5,1180,1.0,0,1180,0,1977,187500.0
3,1.5,1430,1.0,0,820,610,1980,197999.9999
4,1.75,1740,1.0,0,1180,560,1978,204950.0
3,1.0,1320,1.0,0,1320,0,1967,206000.0
1,1.0,930,1.0,0,930,0,1948,210000.0
3,2.25,2110,1.0,0,1360,750,1973,225279.4286
3,2.0,1410,1.0,0,1410,0,1983,229950.0
3,2.0,1570,2.0,2,1050,520,1971,233166.6667
3,1.75,1190,1.0,0,1190,0,1968,235000.0
3,1.75,1280,1.5,0,1280,0,1988,242000.0
3,1.75,1370,1.0,0,1370,0,1982,247199.9999
4,2.5,1800,2.0,0,1800,0,1998,249999.9999
3,1.75,1160,1.0,0,1160,0,1998,250000.0
2,1.5,1088,2.0,0,1088,0,1983,250000.0
3,1.5,880,1.0,0,880,0,1945,253000.0
3,1.75,1700,1.0,0,1700,0,1987,255000.0
3,2.0,1870,1.0,0,1270,600,1986,259000.0
3,1.75,1440,1.0,2,1090,350,1958,260000.0
3,1.5,1270,1.0,0,1150,120,1948,260000.0
2,1.5,1480,1.0,0,940,540,1978,269500.0
3,2.0,1380,1.0,0,1380,0,1989,272000.0
4,2.25,1930,1.0,0,1360,570,1988,280000.0
3,2.5,1413,2.0,0,1413,0,2011,286800.0
4,2.5,1660,2.0,0,1660,0,1994,294999.0
4,2.0,1870,1.5,0,1870,0,1956,310000.0
3,1.0,860,1.5,0,860,0,1927,320000.0
4,2.5,2610,2.0,0,2610,0,1987,325000.0
3,1.75,1160,1.0,0,1160,0,1976,329333.3333
3,2.5,3040,2.0,0,3040,0,2003,330000.0001
3,2.5,1270,2.0,0,1270,0,2004,331366.6668
3,2.5,1530,1.0,0,1270,260,1993,332000.0
2,1.0,740,1.0,0,740,0,1948,342000.0
4,2.75,2250,1.0,0,1480,770,1975,344999.9999
3,2.5,1680,2.0,0,1680,0,2007,345000.0
3,2.0,1380,3.0,0,1380,0,2013,350000.0
2,2.5,1260,3.0,0,1260,0,2005,350000.0
5,3.5,2800,2.0,0,2800,0,1995,379900.0
4,2.5,2150,2.0,0,2150,0,1991,379999.9999
4,2.5,2210,2.0,0,2210,0,1993,382500.0
2,2.5,1620,2.0,0,1620,0,2008,386000.0
3,2.25,2140,2.0,0,2140,0,1986,400000.0
3,1.5,1450,1.0,0,1010,440,1968,402000.0
3,1.5,1880,1.0,0,1480,400,1968,405000.0
4,2.0,1610,1.0,0,1610,0,1967,415000.0001
3,2.5,2890,2.0,0,2890,0,2000,420999.9999
3,2.0,1730,1.0,0,1370,360,1978,430000.0
3,2.25,1230,2.0,0,1080,150,2009,435000.0
2,1.0,1230,1.0,0,1230,0,1928,435000.0
4,2.0,1450,1.5,0,1450,0,1962,440000.0
4,2.5,2470,2.0,0,2470,0,1999,449950.0
4,2.5,1670,2.0,0,1670,0,2005,451000.0
4,1.5,1550,1.5,0,1350,200,1918,458000.0
4,2.5,3250,2.0,0,3250,0,2009,460886.923
2,2.0,1494,2.0,4,1494,0,1943,465000.0
2,2.75,1430,2.0,0,995,435,2006,465000.0
4,2.5,2340,2.0,0,2340,0,2001,465950.0001
3,2.5,1180,3.0,0,1180,0,2010,472000.0
3,2.25,2280,1.0,1,1150,1130,1985,475000.0001
3,2.75,2300,2.0,0,2300,0,2008,479499.9999
4,1.75,2030,1.5,0,2030,0,1975,493000.0001
3,2.5,2970,2.0,0,2970,0,1998,499500.0
3,1.75,2180,1.0,0,1480,700,1961,506000.0
4,2.75,3070,2.0,0,3070,0,2006,535000.0
4,2.25,1990,2.0,0,1990,0,1991,536000.0
3,2.75,2750,1.0,2,1810,940,1978,540000.0001
4,2.25,2030,1.0,0,1590,440,1967,545000.0001
4,1.0,1720,1.5,0,1200,520,1926,547000.0
2,2.5,1380,3.0,0,1380,0,2006,549000.0
3,1.75,2240,2.0,0,2240,0,1976,549999.9998
3,2.0,2340,1.0,1,1170,1170,1971,560000.0
5,1.0,1710,1.5,0,1320,390,1926,560000.0
5,2.0,2700,1.0,0,1540,1160,1962,580000.0
3,2.25,2010,2.0,0,2010,0,1985,605000.0
3,2.5,2830,2.0,0,2830,0,1989,605500.0
4,2.5,2490,2.0,0,2490,0,1983,615999.9999
3,2.5,2670,2.0,0,2670,0,2003,645325.0001
3,2.0,1880,1.0,0,1030,850,1927,667500.0
4,2.75,2700,2.0,0,2700,0,1976,668999.9998
6,1.75,2740,1.0,3,1370,1370,1953,675000.0
4,2.5,2650,2.0,0,2110,540,1988,719999.9999
4,2.75,2630,2.0,0,2630,0,1994,725000.0001
3,2.5,2300,1.0,0,2300,0,2005,738500.0
4,2.5,2940,2.0,0,2940,0,1991,752000.0
3,2.5,2590,2.0,0,2590,0,1988,809000.0001
7,4.25,3670,2.0,1,2800,870,1964,823999.9999
5,2.75,3010,2.0,0,3010,0,1994,837699.9999
4,3.5,3860,2.0,0,3120,740,1996,840000.0
4,2.75,3150,1.0,0,2480,670,1986,853999.9997
5,3.5,3130,2.0,0,2570,560,2014,866059.0
4,4.25,3010,2.0,3,1940,1070,1951,870000.0
3,1.75,2960,1.0,2,1480,1480,1952,936000.0
4,3.5,2650,2.0,0,2060,590,2001,1008000.0
4,3.5,4170,2.0,0,4170,0,2004,1200000.0
4,4.0,4420,2.0,0,4420,0,2013,1325000.0
3,3.5,4360,2.0,3,2960,1400,2008,1555000.0
6,1.0,1370,1.5,0,1120,250,1931,175000.0
2,1.0,660,1.0,0,660,0,1915,175000.0
1,1.0,720,1.0,0,720,0,1914,190000.0
3,1.0,1080,1.5,0,1080,0,1900,192500.0
2,1.5,1820,2.0,0,1820,0,1921,206000.0
2,1.0,1080,1.0,0,1080,0,1958,230000.0
3,1.75,1670,1.0,0,1170,500,1978,239950.0
2,1.0,670,1.0,0,670,0,1942,240000.0
3,2.0,1260,1.0,0,1260,0,1986,242000.0
3,1.0,1130,1.0,0,1130,0,1958,243069.2307
2,1.0,790,1.0,0,790,0,1942,250275.0
4,2.0,2030,1.5,0,1430,600,1947,253779.0
4,1.75,1820,1.0,0,1080,740,1980,264000.0
4,1.75,1770,1.0,0,1050,720,1983,264950.0
4,1.5,2050,1.0,0,1050,1000,1963,265000.0
3,2.25,1584,2.0,0,1584,0,2012,267000.0
3,2.25,1720,1.0,0,1320,400,1969,274500.0
5,1.75,2150,1.0,0,1460,690,1970,279950.0001
3,1.0,990,1.0,0,990,0,1960,284950.0
4,2.5,2570,1.0,0,1590,980,1979,287500.0001
3,2.0,1380,1.0,0,1380,0,1966,295000.0
5,2.5,2220,1.0,0,1110,1110,1968,299000.0
3,2.5,1700,2.0,0,1700,0,2000,300000.0
3,1.0,910,1.0,0,910,0,1971,300000.0
3,2.25,1490,2.0,0,1220,270,2010,309000.0
4,2.5,2660,1.0,0,1740,920,1960,310000.0
3,2.5,1730,2.0,0,1730,0,1993,315000.0
4,2.5,1820,2.0,0,1820,0,1994,322500.0
3,2.75,2200,1.0,0,1280,920,1977,325000.0
3,2.5,1600,2.0,0,1600,0,2005,329999.9999
2,1.0,940,1.0,0,940,0,1910,337945.75
2,1.0,1100,1.0,0,1100,0,1954,343566.0
3,2.5,2640,2.0,0,1680,960,1991,365000.0
3,2.5,1950,2.0,0,1950,0,1997,375000.0
3,3.25,1689,3.0,0,1689,0,2008,384400.0
3,1.75,1050,1.5,0,950,100,1928,400000.0
5,2.5,3600,1.0,0,2410,1190,1968,403500.0
4,2.0,1970,1.0,0,1820,150,1961,409999.9999
4,2.5,2020,2.0,0,2020,0,2010,414999.9999
3,1.75,1270,1.0,0,1270,0,1952,415000.0
3,2.0,1670,1.0,0,1170,500,1972,423999.9999
4,2.5,2410,2.0,0,2410,0,2000,440000.0
3,1.75,1180,1.0,0,760,420,1928,450000.0
3,1.75,1180,1.0,0,1180,0,1981,455000.0
3,3.25,2770,2.0,0,1980,790,2006,461000.0001
3,1.75,1510,1.0,2,860,650,1925,465000.0
5,2.5,2240,1.0,0,1140,1100,1966,469000.0
3,1.75,1700,1.0,0,1230,470,1977,475000.0
3,3.25,1380,3.0,0,1380,0,2008,482000.0
2,2.5,1430,3.0,0,1410,20,2008,485000.0
5,3.25,3850,2.0,2,3030,820,2002,507000.0
4,1.75,1770,1.0,0,1170,600,1968,507000.0
3,3.5,1360,2.0,0,1040,320,2007,515000.0
4,2.5,2920,2.0,0,2920,0,2003,515499.9999
4,2.5,2610,2.0,0,2610,0,2008,534999.9999
3,2.0,2120,2.0,0,2120,0,2003,535000.0001
3,1.75,1930,1.0,0,1930,0,2013,536751.0
4,2.5,2050,2.0,0,2050,0,1989,540000.0
3,1.75,1970,1.0,0,1420,550,1963,540000.0
3,2.5,1560,1.5,0,1360,200,1936,545500.0
5,2.25,1870,1.0,0,1170,700,1961,554000.0
3,1.75,2040,1.0,0,1120,920,1958,554999.9999
5,3.0,2795,2.0,0,2795,0,1996,562000.0001
2,2.0,1690,1.0,0,1690,0,2004,564000.0
5,3.5,3260,2.0,0,3260,0,1969,568450.0002
4,2.5,2290,2.0,0,2290,0,1996,570000.0001
5,3.25,3160,2.0,0,3160,0,1980,574950.0001
4,2.5,3250,2.0,0,3250,0,2008,579999.9999
5,2.25,2480,2.0,0,2480,0,1978,615000.0001
4,2.5,1910,2.0,0,1910,0,1987,620000.0
4,2.5,2807,2.0,0,2807,0,1996,630000.0
5,2.75,2870,1.0,0,1650,1220,1976,646000.0
3,1.75,2920,1.0,0,1620,1300,1981,650000.0
3,3.0,3450,2.0,0,3450,0,1983,688000.0
4,2.5,3210,2.0,0,3210,0,1995,690408.6209
4,1.75,1980,1.0,0,990,990,1948,711000.0
3,2.5,2420,2.0,4,1690,730,1989,739888.0
4,2.5,2790,2.0,0,2790,0,1997,764000.0
3,2.25,2910,2.0,0,2910,0,1990,770000.0001
4,2.5,3170,2.0,0,3170,0,2008,819999.9999
4,3.5,3810,2.0,0,3810,0,1938,825000.0
5,3.5,3450,1.0,0,2350,1100,1972,850000.0
4,2.25,2190,2.0,0,1800,390,1918,855000.0
4,2.5,3640,2.0,0,3640,0,1999,913000.0
4,2.5,4270,1.0,0,2680,1590,1991,975000.0001
4,3.5,4680,2.0,0,3360,1320,2005,1160000.0
4,3.25,4290,1.0,3,2690,1600,1997,1384000.0
4,2.75,3870,2.0,0,3870,0,2005,1399950.0
6,5.0,6050,2.0,3,6050,0,2001,1600000.0
3,2.0,1340,1.0,0,920,420,1912,186000.0
3,1.0,1330,2.0,0,1330,0,1905,197500.0
3,1.5,1140,1.0,0,1140,0,1960,199999.9999
3,2.0,1440,1.0,0,1440,0,1983,210000.0
3,1.75,1150,1.0,0,1150,0,1983,220083.3333
3,2.25,1640,1.0,0,1140,500,1984,221000.0
3,1.0,1320,1.0,0,880,440,1961,232500.0
3,1.75,1750,2.0,0,1750,0,1976,232603.0
4,2.0,1790,1.0,1,1670,120,1960,240000.0
4,2.0,2080,1.0,0,1040,1040,1950,247999.9999
3,1.0,1050,1.0,0,1050,0,1959,249000.0
3,1.75,1840,1.0,0,1840,0,1966,265000.0
4,1.75,1530,1.5,0,1530,0,1968,269900.0
3,1.75,1860,1.0,0,1860,0,1971,275000.0
3,1.0,1210,1.5,0,1210,0,1901,285000.0
3,2.0,1300,1.5,0,1300,0,1933,287000.0
4,2.5,3490,2.0,0,3490,0,2003,297857.1429
3,2.5,1800,2.0,0,1800,0,2011,309000.0
4,1.5,1220,1.0,0,1220,0,1980,309999.9999
3,1.75,1900,1.5,0,1070,830,1903,311000.0
2,1.0,920,1.0,0,920,0,1939,319950.0
4,1.0,1940,1.5,0,1940,0,1947,323833.3333
3,2.5,2238,2.0,0,2238,0,2011,330000.0
3,2.5,2480,2.0,0,2480,0,2004,340000.0
3,2.0,2140,1.0,0,1480,660,1966,346150.0001
2,1.0,1620,1.0,0,850,770,1921,350000.0
3,2.0,1430,1.0,0,1430,0,1945,352450.0
4,2.5,2850,2.0,0,2850,0,2004,360000.0001
3,2.5,2160,1.5,0,1260,900,1909,378749.9999
4,2.25,2150,1.0,0,1090,1060,1963,380000.0
3,1.75,2310,1.0,0,1630,680,1978,385000.0
3,2.25,1600,1.0,0,1090,510,1979,390000.0
4,1.0,1980,1.0,0,1430,550,1968,395000.0
4,2.25,1820,1.5,0,1320,500,1930,399888.0001
2,1.0,1260,1.0,0,1260,0,1947,405000.0001
6,2.75,2520,1.0,0,1320,1200,1962,410000.0001
4,2.5,2640,2.0,0,2640,0,1987,429900.0001
3,1.75,1310,1.0,0,1310,0,1948,435000.0001
2,1.75,1440,1.0,0,1440,0,2005,437000.0
3,1.75,1170,1.0,0,1170,0,1968,440000.0
4,2.5,2400,2.0,0,2400,0,2003,449999.9999
3,1.75,1610,1.0,0,1610,0,1955,450000.0
3,1.0,1320,2.0,0,1320,0,1900,464000.0
3,2.0,1730,1.0,0,1730,0,1997,470000.0
3,2.25,1820,2.0,0,1820,0,1983,489950.0
3,1.75,1840,1.0,0,920,920,1910,499000.0
3,2.5,2840,1.0,3,1870,970,1994,500000.0
3,2.5,1610,2.0,0,1610,0,1996,505000.0
2,1.0,1570,1.0,0,1150,420,1952,506000.0
3,2.5,2120,2.0,0,2120,0,2003,507000.0
4,2.5,2610,2.0,0,2610,0,1998,510000.0
3,2.75,2020,1.0,0,1270,750,1954,518999.9999
5,3.75,3090,2.0,0,3090,0,2014,540499.9999
3,2.25,1240,3.0,0,1240,0,2008,543000.0
4,2.25,2060,1.0,0,1320,740,1962,558000.0
3,2.5,1940,1.0,0,970,970,1948,575999.9999
4,2.25,2160,1.0,0,2160,0,1969,579999.9999
4,2.5,2840,2.0,0,2840,0,2001,584999.9999
3,1.5,1470,2.0,0,1470,0,1907,590299.9999
3,2.5,2650,2.0,0,2650,0,1994,592105.7143
3,2.0,2540,1.0,0,2540,0,2007,599999.9998
4,2.25,3070,2.0,0,3070,0,1970,599999.9999
3,3.25,1530,3.0,0,1530,0,2006,607500.0
4,3.25,2520,1.5,0,1550,970,1931,618249.9999
4,2.5,2270,1.0,0,1500,770,1972,619849.9999
4,2.5,2310,2.0,0,2310,0,2008,646000.0
4,3.0,2620,1.0,0,1870,750,1956,659500.0
4,2.5,2496,2.0,0,2496,0,1998,661000.0001
6,2.0,1670,1.0,0,900,770,1911,680000.0001
3,2.75,3200,2.0,0,3200,0,2004,711999.9999
4,2.5,2440,2.0,0,2440,0,1987,719999.9999
3,2.5,2320,1.0,0,2320,0,2008,728050.0
4,2.5,2650,2.0,0,2650,0,2012,734989.9999
3,3.5,3390,2.0,0,3040,350,2012,750000.0001
4,2.25,2160,1.0,0,1080,1080,1947,756000.0
4,2.75,3010,2.0,0,3010,0,1996,775000.0001
4,2.5,2590,2.0,0,2590,0,2001,799000.0001
4,2.25,2370,1.0,2,1440,930,1959,899000.0
5,2.0,3530,1.5,0,3530,0,1925,929999.9999
2,2.5,2540,2.0,0,2540,0,2004,945000.0001
5,3.0,3330,2.0,0,2610,720,1977,950833.3334
3,2.5,2430,2.0,1,2430,0,1989,1027000.0
5,3.5,3990,2.0,0,3990,0,2001,1068000.0
4,3.5,3820,2.0,0,3280,540,1990,1240000.0
4,4.5,4750,2.0,2,3600,1150,2005,1309500.0
3,3.5,3870,2.0,0,2760,1110,2002,1440000.0
5,4.75,5990,2.0,4,4050,1940,2002,2200000.0
2,1.0,1020,1.0,0,1020,0,1948,175000.0
3,2.25,1230,1.5,0,1230,0,1913,200000.0
2,1.0,860,1.0,0,860,0,1949,200000.0
3,1.0,1150,1.0,0,1150,0,1953,203000.0
3,1.0,960,1.0,0,960,0,1960,205000.0
2,2.0,1680,2.0,0,1680,0,1910,210000.0
2,2.0,1310,2.0,0,1310,0,2004,218000.0
3,1.0,1300,1.0,0,1300,0,1960,237000.0
3,1.75,1880,1.0,0,1330,550,1985,248400.0
1,1.0,800,1.0,0,680,120,1931,250000.0001
4,2.0,2200,1.0,0,1100,1100,1979,279000.0
3,2.0,1470,1.0,0,1470,0,1987,280000.0
4,2.0,1890,2.0,0,1890,0,1997,281999.9999
2,1.0,840,1.0,0,840,0,1948,325000.0
3,2.5,1820,2.0,0,1820,0,1983,329950.0
3,2.25,1860,2.0,0,1860,0,1995,330000.0
3,2.0,1510,1.0,0,1510,0,1942,331999.9999
4,3.0,2240,2.0,0,2240,0,1992,337000.0001
3,2.5,2570,2.0,0,2570,0,2014,339990.0
4,2.5,2040,2.0,0,2040,0,1996,355000.0
2,1.0,1240,1.0,1,1000,240,1943,355000.0
5,2.25,2290,1.0,0,1290,1000,1973,359899.9999
3,2.25,1940,1.0,0,1100,840,1981,359949.9999
4,2.5,2550,2.0,0,2550,0,2005,371000.0
4,2.5,1890,1.0,0,1230,660,1978,378000.0001
3,1.5,1520,1.0,0,1020,500,1949,380000.0
3,1.0,1160,1.5,0,1160,0,1910,390000.0
3,1.0,1500,1.0,0,900,600,1925,395000.0
4,2.5,2320,2.0,0,2320,0,1997,397000.0
4,2.25,2420,1.0,0,1400,1020,1973,400000.0001
3,1.0,1430,1.5,0,1430,0,1950,400000.0
3,1.0,1460,1.5,0,1460,0,2002,405000.0
2,1.0,1260,1.0,0,690,570,1925,412000.0
5,3.0,2630,2.0,0,1670,960,2013,420000.0
5,2.75,2280,1.0,0,1300,980,1959,419999.9999
3,2.5,2540,2.0,0,2540,0,1999,425000.0
3,2.25,1790,1.0,0,1290,500,1967,424999.9999
5,3.0,3110,1.0,0,1790,1320,1977,436499.9999
3,2.75,1910,1.0,0,1160,750,1979,441000.0
4,2.5,2040,2.0,0,2040,0,1994,443500.0
4,2.5,2510,2.0,2,2510,0,2006,448000.0
3,2.0,1430,1.0,0,980,450,1947,450000.0
4,2.25,2450,1.0,2,1650,800,1954,455000.0001
3,2.25,1470,2.0,0,1470,0,1985,454999.9999
3,1.5,1440,1.0,0,1440,0,1975,456000.0
3,2.5,1870,2.0,0,1870,0,2003,458000.0001
3,1.75,1780,1.0,0,1210,570,1976,477000.0
4,1.0,2080,1.0,0,1040,1040,1941,480000.0
4,3.0,1630,1.0,0,1110,520,1990,482500.0
4,2.25,2170,1.0,0,1300,870,1976,488800.0
4,2.0,2120,1.0,0,1060,1060,1940,489000.0001
4,1.0,1360,1.5,0,1360,0,1917,511500.0
3,2.25,1750,3.0,0,1750,0,2001,524999.9999
5,2.5,2200,1.5,0,1420,780,1916,547000.0
4,2.75,3260,2.0,0,3260,0,2013,565000.0
3,3.5,1890,2.0,0,1640,250,1999,587206.0
3,2.75,3290,2.0,0,3290,0,1993,595000.0002
4,2.5,2620,2.0,0,2620,0,1996,605000.0
3,2.5,1850,2.0,0,1850,0,1989,623000.0001
3,2.5,2440,2.0,0,2440,0,2014,624999.9999
4,2.5,2090,2.0,0,2090,0,1986,632499.9999
2,1.75,1760,1.0,0,880,880,1930,640000.0
4,2.5,3040,2.0,0,3040,0,2003,649999.9999
4,3.25,3030,2.0,0,3030,0,1988,660000.0001
4,2.25,2870,2.0,1,2220,650,1926,665899.9999
5,2.75,3260,1.0,0,1630,1630,1964,681500.0
4,2.5,3290,2.0,0,3290,0,2003,715000.0
3,3.5,3690,2.0,0,3690,0,2001,724999.9999
4,3.25,3940,2.0,3,3440,500,2000,724999.9999
6,1.75,2380,2.0,0,2380,0,1917,725000.0001
2,2.5,2770,2.0,0,2770,0,2006,754800.0
4,2.5,2970,2.0,0,2970,0,2014,775949.9999
3,2.25,2140,2.0,0,2140,0,1905,780000.0
4,1.75,2050,1.0,3,1450,600,1974,790000.0001
4,2.75,3150,2.0,0,3150,0,2004,800000.0
3,3.25,3240,2.0,0,3240,0,2001,812000.0001
5,2.25,2780,2.0,0,2780,0,1978,830000.0001
3,2.25,2870,2.0,0,2250,620,1995,849999.9999
4,3.0,3740,2.0,0,3060,680,1988,869000.0
3,2.25,2060,1.0,0,1610,450,1975,885000.0
4,3.5,2970,2.0,0,2340,630,1997,905000.0001
3,3.25,2660,2.0,0,2170,490,2003,915000.0001
4,2.75,3730,2.0,0,3730,0,2012,925000.0001
4,2.0,3140,1.0,0,2040,1100,1959,924999.9999
3,3.25,3050,1.0,4,1650,1400,1962,950000.0001
4,2.5,3360,2.0,0,3360,0,1988,949999.9999
3,2.75,2470,2.0,0,2470,0,1960,970500.0
4,2.25,2870,1.5,0,1980,890,1905,994500.0001
4,4.5,3850,2.0,2,3000,850,1998,994999.9999
3,3.0,4910,2.0,0,4000,910,1989,1080000.0
6,4.25,6900,2.0,0,4820,2080,2002,1135000.001
5,3.25,3240,1.5,4,2500,740,1939,1234582.0
7,5.5,6630,2.0,0,4930,1700,2004,1240000.0
5,4.0,3366,2.5,2,2966,400,1937,1300000.0
4,3.5,4410,2.0,0,4410,0,1989,1320000.0
5,3.25,3840,3.0,3,2750,1090,2008,1462497.0
7,3.5,4640,2.0,1,2860,1780,1965,1950000.0
2,1.0,1230,2.0,0,830,400,1948,375000.0
4,1.5,1550,1.0,0,1000,550,1956,418000.0
4,1.75,1780,1.0,0,890,890,1943,442900.0001
4,2.25,2330,2.0,0,2330,0,1986,639500.0001
3,1.75,2610,1.5,0,1680,930,1934,750000.0001
4,2.0,2160,1.5,1,2160,0,1928,849000.0
3,2.5,3290,2.0,0,3290,0,2000,930000.0001
4,2.5,2380,2.0,0,2380,0,1999,330000.0001
4,2.5,2580,2.0,0,2580,0,2004,373999.9999
4,2.5,2040,1.0,0,1420,620,1963,500000.0
4,2.5,2090,2.0,0,2090,0,1990,545000.0
4,2.5,2370,2.0,0,2370,0,1966,687000.0001
4,2.5,2130,1.0,0,1230,900,1963,732600.0
3,1.75,2870,1.5,0,1840,1030,1907,801999.9999
4,2.5,2810,2.0,0,2810,0,1989,810000.0
4,3.5,3530,2.0,1,2570,960,1987,874150.0001
3,1.5,1270,2.0,0,1270,0,2012,160797.0001
3,1.0,1200,1.0,0,1200,0,1943,165000.0
5,2.5,1740,1.0,0,1740,0,1959,199950.0
3,1.5,1090,1.0,0,1090,0,1968,200000.0
2,1.75,880,1.0,0,880,0,1945,205425.0
3,2.0,1340,1.0,0,1340,0,1931,214999.9999
3,1.75,1580,1.0,0,1580,0,1967,225000.0
3,2.25,1650,2.0,0,1650,0,1985,233500.0
2,1.0,870,1.0,0,870,0,1940,234000.0
6,3.0,2180,2.0,0,2180,0,1980,235000.0
4,1.75,1450,1.5,0,1180,270,1962,235000.0
3,1.0,1170,1.0,0,1170,0,1968,235000.0
3,1.75,1230,1.0,0,1230,0,1984,239950.0
3,1.0,1000,1.0,0,1000,0,1968,249000.0
2,1.75,1500,1.0,0,1500,0,1963,249500.0
3,2.0,1310,1.0,0,1310,0,1990,249900.0
4,2.5,2000,2.0,0,2000,0,1989,260000.0002
3,1.75,1390,1.0,0,1390,0,1962,261350.0
3,1.75,1760,1.0,0,1760,0,1966,264000.0
3,1.0,1620,1.5,0,1620,0,1928,265000.0
3,1.75,1840,1.0,0,1240,600,1976,269500.0
4,2.5,2540,2.0,0,2540,0,1977,269950.0001
2,1.0,1180,1.0,0,1180,0,1949,275000.0
3,1.0,1080,1.0,0,1080,0,1952,275000.0
2,1.0,1010,1.0,0,1010,0,1925,280000.0
3,2.5,1660,2.0,0,1660,0,2003,285000.0
3,2.75,1100,2.0,0,780,320,2008,286000.0
3,1.0,1150,1.0,0,990,160,1932,290000.0
2,2.0,1610,2.0,0,1610,0,1930,290900.0
3,1.0,880,1.5,0,880,0,1946,291500.0
2,1.0,1060,1.0,0,1060,0,1951,299995.0
4,2.5,2620,2.0,0,2620,0,2008,300000.0
4,2.5,1840,2.0,0,1840,0,2004,300000.0001
3,2.5,2540,2.0,0,2540,0,2006,310000.0
5,3.0,2300,2.0,0,2300,0,2013,312891.0
3,2.5,2280,2.0,0,2280,0,1998,320000.0
4,2.25,2010,2.0,0,2010,0,1975,322199.9999
4,1.75,2110,1.0,0,1170,940,1975,324000.0
3,1.0,1030,1.0,0,1030,0,1969,326000.0
3,2.5,2242,2.0,0,2242,0,2011,329900.0
4,1.5,1150,1.5,0,1150,0,1970,334000.0
3,1.75,1310,1.0,0,1310,0,1993,337000.0
3,1.5,1420,2.0,0,1140,280,2008,345000.0
3,1.0,1140,2.0,0,1140,0,1904,345000.0
3,3.75,1950,1.0,0,1360,590,1959,345100.0001
3,2.5,2110,2.0,0,2110,0,1989,345950.0
3,1.75,1270,1.0,0,880,390,1950,346000.0
3,1.0,1270,1.0,0,1270,0,1955,347000.0
3,2.0,2420,1.0,0,1210,1210,1949,349900.0
7,3.0,2800,1.0,2,1400,1400,1963,350000.0
3,1.75,1660,1.5,0,1660,0,1957,350000.0
4,1.5,1720,1.0,0,1720,0,1953,360000.0
3,2.5,2430,2.0,0,2430,0,1997,362300.0
2,1.5,940,2.0,0,940,0,2009,362500.0
4,2.0,1940,1.0,0,1940,0,1962,365000.0
4,2.5,1870,2.0,0,1870,0,1990,374999.9999
2,1.0,880,1.0,0,880,0,1950,379509.1667
4,2.75,2700,2.0,0,2700,0,1984,385000.0001
3,3.25,1630,3.0,0,1630,0,2007,385000.0
3,1.75,1880,1.0,0,1880,0,1959,389800.0001
3,1.75,2390,1.0,0,1350,1040,1955,396500.0
3,1.75,1560,1.0,0,810,750,1940,399950.0
4,1.75,1700,1.5,0,1340,360,1965,399999.9999
2,0.75,1020,2.0,0,1020,0,2009,402101.0
3,1.0,1830,1.0,0,1200,630,1960,403499.9999
3,2.25,1520,3.0,0,1520,0,2004,405000.0
4,2.5,2170,1.0,3,1350,820,1955,415000.0
3,2.0,1200,1.0,0,880,320,1937,420000.0
3,2.25,1580,1.0,0,1180,400,1992,424999.9999
3,1.75,1300,1.0,0,1300,0,1981,429999.9999
3,1.75,1560,1.0,0,1250,310,1983,440000.0
4,2.5,2520,2.0,0,2520,0,1990,442000.0001
3,1.75,1600,1.0,0,1050,550,1977,442500.0
4,2.5,1850,1.0,0,1230,620,1930,449000.0
3,2.25,1780,1.0,2,1340,440,1972,449500.0001
4,1.75,2160,1.0,0,1260,900,1942,450000.0
4,1.75,2120,1.0,0,1060,1060,1956,453000.0
3,2.0,1890,2.0,0,1430,460,2012,458500.0
4,2.5,2000,2.0,0,2000,0,2003,459950.0
3,2.5,2150,2.0,0,2150,0,1992,469999.9999
3,1.75,1800,1.0,0,900,900,1905,471001.0
3,2.25,2110,2.0,0,2110,0,1978,479000.0
3,2.25,1470,2.0,0,1080,390,1984,490000.0
4,2.5,1540,2.0,0,1540,0,2014,491234.0
4,2.5,1830,1.0,0,1540,290,1973,493999.9999
3,2.0,2950,2.0,0,2310,640,1918,495000.0
3,2.25,1630,2.0,0,1630,0,2005,497000.0
6,2.5,2890,1.0,0,1630,1260,1977,502000.0
5,3.25,2910,2.0,0,2040,870,2013,515000.0
3,1.75,1840,1.0,0,1840,0,1964,550000.0
3,2.5,1900,2.0,0,1900,0,1988,550000.0
3,2.5,1960,2.0,0,1960,0,1989,559999.9999
4,2.5,2300,2.0,0,2300,0,1990,559999.9999
3,2.25,1300,2.0,0,1000,300,2006,562499.9999
4,2.0,1730,1.0,0,1060,670,1924,569000.0
3,2.5,2060,1.0,0,1330,730,1976,577000.0
3,2.5,1640,3.0,0,1640,0,2009,579000.0
4,2.5,3220,1.5,0,3220,0,1966,589999.9999
3,2.5,2260,2.0,0,2260,0,1987,599999.9999
6,2.75,2660,1.0,0,1550,1110,1962,603499.9999
5,2.0,2130,1.5,0,1270,860,1926,614999.9999
4,3.5,2960,2.0,0,2960,0,2014,633634.0
3,2.5,1500,2.0,0,1200,300,2014,649950.0
4,2.5,2400,2.0,0,2400,0,1990,650000.0
3,3.25,1980,3.0,0,1980,0,1987,660000.0
5,3.0,3190,1.0,2,1890,1300,2013,664950.0
3,2.5,3310,2.0,2,2440,870,2008,670000.0
4,2.5,2810,2.0,0,2810,0,1982,674999.9999
4,2.5,2650,1.0,0,1680,970,1960,715000.0
4,2.5,3420,2.0,0,3420,0,1988,725000.0
4,2.25,2270,1.0,0,1340,930,1954,735000.0001
4,2.5,2300,2.0,0,2300,0,1999,774999.9999
4,3.5,3910,2.0,0,2490,1420,1987,780000.0
4,3.0,3520,1.0,0,1980,1540,1954,800000.0
3,2.25,2380,1.0,0,1450,930,1972,800000.0001
5,2.5,4470,2.5,0,4470,0,1984,831500.0001
4,2.5,3030,2.0,0,3030,0,1998,834999.9999
4,3.25,3440,2.0,0,3440,0,2006,905000.0
5,3.5,3500,2.0,0,2570,930,1996,905000.0
4,2.5,3160,2.0,0,3160,0,1965,950100.0
4,3.75,3520,1.5,0,2200,1320,1913,1220000.0
4,2.5,4570,2.0,4,4570,0,1948,1580000.0
2,1.0,690,1.0,0,690,0,1942,139000.0
3,1.5,1010,1.0,0,1010,0,1962,160000.0
3,1.0,1000,1.0,0,1000,0,1991,171758.3333
3,1.0,1050,1.0,0,1050,0,1983,194000.0
3,1.0,1410,1.0,0,1410,0,1951,198995.0
2,1.0,970,1.0,0,970,0,1956,210000.0
3,1.5,1330,1.0,0,1330,0,1968,218000.0
3,1.0,880,1.0,0,880,0,1945,218000.0
3,1.75,1330,1.0,0,1330,0,1968,225000.0
4,1.75,1850,1.0,0,1270,580,1944,230000.0
4,2.75,2000,2.0,0,2000,0,1997,236000.0
3,2.25,1670,1.0,0,1190,480,1977,252000.0
2,2.0,1180,1.0,0,1180,0,1940,257499.9999
3,1.0,1490,1.0,0,1120,370,1969,258000.0001
3,1.0,990,1.0,0,990,0,1968,278900.0
3,2.5,1970,2.0,0,1090,880,1988,289000.0
2,1.0,650,1.0,0,650,0,1950,295000.0
3,1.0,2150,1.0,0,2150,0,1954,300000.0
2,1.0,750,1.0,0,750,0,1941,300000.0
4,2.0,1310,1.0,0,1310,0,1953,304000.0
4,2.25,2210,2.0,0,2210,0,1968,304999.9999
4,1.75,2700,1.0,0,1380,1320,1958,314900.0001
5,2.5,2360,1.0,0,1180,1180,1962,316999.9999
4,2.5,2510,1.0,0,1610,900,1978,319000.0
3,1.5,1460,1.0,0,1460,0,1955,324950.0
3,1.0,850,1.0,0,850,0,1948,325000.0
3,1.75,2000,1.0,0,1300,700,1968,325187.5
2,1.0,900,1.0,0,900,0,1956,329950.0
3,1.0,1480,1.0,0,970,510,1963,336500.0
4,2.0,2470,1.5,0,1970,500,1948,339000.0
3,1.0,1100,1.0,0,720,380,1942,339000.0
2,1.75,1210,1.0,0,1210,0,1982,342500.0
4,1.75,1760,1.0,2,1180,580,1950,343500.0
3,1.5,1360,1.0,0,1360,0,1966,348500.0
4,2.5,2090,2.0,0,2090,0,1989,349950.0
4,3.0,2560,2.0,0,2560,0,2004,350000.0
2,1.0,740,1.0,0,740,0,1922,350000.0
2,2.25,930,2.0,0,630,300,2007,355000.0
3,1.75,1500,1.0,0,1500,0,1957,360000.0
4,1.75,1450,1.0,0,1450,0,1960,362500.0
2,1.75,1240,1.5,0,1240,0,1906,362750.0
3,1.75,1840,1.0,0,1340,500,1977,366000.0
3,1.0,1660,1.0,0,1160,500,1978,367500.0
3,2.5,1740,2.0,0,1740,0,1992,379000.0001
3,2.25,1860,2.0,0,1860,0,1963,379999.9999
4,1.75,1250,1.0,0,1250,0,1959,391400.0
3,2.5,1600,2.0,0,1600,0,2007,395000.0
4,1.75,1540,1.0,0,770,770,1943,395000.0
3,2.5,2590,1.0,0,2590,0,1976,396500.0
3,2.5,2970,1.0,0,1510,1460,1967,400000.0001
3,2.0,1230,1.0,0,990,240,1984,399999.9999
3,2.5,3170,2.0,0,2360,810,1995,405000.0001
3,2.5,2280,2.0,0,2280,0,2011,415000.0
3,1.75,1070,1.0,0,1070,0,1977,415000.0001
3,2.5,2140,2.0,0,2140,0,2005,420000.0
3,2.5,1930,2.0,0,1930,0,1990,424999.9999
4,1.5,1600,1.5,0,1600,0,1946,425000.0001
4,2.5,1890,1.0,0,1290,600,1980,437000.0
3,1.75,1520,1.0,0,790,730,1948,438000.0
3,1.75,2000,1.0,2,1480,520,1957,439999.9999
4,2.5,2950,2.0,0,2950,0,2005,454999.9999
3,2.25,1430,2.0,0,980,450,1996,457500.0001
3,1.75,1150,1.0,0,1150,0,1959,464500.0
3,2.5,1500,1.0,0,900,600,1920,485000.0
3,2.0,1300,1.0,0,1300,0,1955,502000.0
3,2.25,1420,3.0,0,1420,0,2006,510000.0
3,1.75,2300,1.0,0,2300,0,1984,520000.0
2,1.5,1580,1.0,2,1280,300,1941,530000.0
3,2.5,2070,2.0,0,2070,0,1999,535000.0
5,2.75,3831,2.0,4,3831,0,1959,542500.0
2,1.0,2034,1.0,4,1159,875,1947,549000.0
4,2.5,4620,2.0,0,4620,0,1991,575000.0
3,2.25,2400,1.5,0,1440,960,1926,575000.0
3,2.5,2270,2.0,0,2270,0,1998,585000.0
4,2.5,3190,2.0,0,3190,0,2006,589950.0001
5,2.75,2730,1.0,0,2080,650,1968,599000.0001
4,3.25,4690,2.0,2,3680,1010,1995,600000.0001
4,1.75,1740,1.0,0,1740,0,1968,599999.9999
3,1.75,1720,1.0,0,960,760,1924,615000.0
4,2.5,2450,2.0,0,2450,0,1994,620000.0001
3,2.5,2410,1.0,0,1820,590,1976,624999.9998
4,2.5,2050,2.0,0,2050,0,2012,639887.9999
4,2.5,2341,2.0,0,2341,0,1997,640000.0
2,2.25,2550,2.0,0,1860,690,1902,660000.0
6,2.75,2840,1.0,0,1420,1420,1961,664999.9999
4,2.25,2420,2.0,0,2420,0,1973,672500.0001
3,3.5,2300,1.0,0,2300,0,2004,675000.0
3,1.5,1820,1.5,0,1640,180,1946,683500.0001
4,1.75,2330,1.5,0,1510,820,1929,687500.0
3,1.75,2200,1.0,0,1500,700,1978,689000.0001
4,2.5,2650,2.0,0,2650,0,1986,725000.0
4,2.5,2440,2.0,0,2440,0,2013,745641.0
4,3.25,3090,2.0,0,2370,720,2004,751000.0
4,2.75,2610,1.0,0,1760,850,1978,762499.9999
4,3.5,3190,2.0,0,3190,0,2010,790000.0001
3,3.5,2130,2.0,2,1530,600,1908,819000.0
3,2.5,3200,1.0,0,3200,0,2000,839000.0002
3,2.0,2540,1.5,0,1840,700,1930,845000.0
4,3.5,3920,2.0,0,3920,0,1996,850000.0
4,3.0,3330,1.0,0,1790,1540,1958,849999.9999
4,2.25,3550,1.0,0,1830,1720,2010,858999.9999
4,2.5,3220,2.0,0,3220,0,1996,875000.0001
4,2.5,3030,3.0,0,3030,0,2005,880000.0001
4,3.0,3580,1.5,0,3580,0,1985,925000.0
3,2.25,3060,1.5,2,1810,1250,1930,970000.0001
4,3.75,3820,1.0,0,3820,0,1994,1215000.0
4,2.5,3220,1.0,0,1680,1540,1973,1250000.0
0,0.0,4810,2.0,0,4810,0,1990,1295648.0
5,4.75,6390,2.0,0,4560,1830,1940,2466350.0
2,1.0,890,1.0,0,890,0,1942,150000.0001
3,1.0,1090,1.0,0,1090,0,1969,152000.0
1,0.75,930,1.0,0,930,0,1941,190000.0
2,1.0,1120,1.0,0,1120,0,1944,190368.75
3,1.0,1320,1.0,0,1320,0,1966,196500.0
3,2.0,1190,1.0,0,1190,0,1995,200000.0
3,1.0,1150,1.5,0,1150,0,1938,200000.0
3,1.0,1050,1.0,0,1050,0,1958,205000.0
3,1.0,1230,1.0,0,1230,0,1965,205000.0001
3,2.75,2210,2.0,0,2210,0,2008,215999.9999
3,1.0,1250,1.5,0,1250,0,1955,233000.0
4,2.0,1570,2.0,0,1570,0,1984,235000.0
3,2.25,1481,2.0,0,1481,0,2012,240000.0
3,2.0,1410,1.0,0,1410,0,1985,245000.0
3,2.25,1640,1.0,0,1180,460,1968,245700.0001
3,2.5,1620,2.0,0,1620,0,1989,246500.0
4,2.25,1830,2.0,0,1830,0,1990,248999.9999
3,2.5,1720,2.0,0,1720,0,1992,255950.0
5,2.5,2025,2.0,0,2025,0,2007,260000.0
3,1.5,1580,1.0,0,1140,440,1954,260000.0
3,1.5,1150,1.0,0,1150,0,1951,265950.0
2,1.0,2060,1.0,0,1260,800,1962,270000.0
3,2.5,1670,1.0,0,1300,370,1990,270000.0
2,1.0,770,1.0,0,770,0,1927,275000.0
4,2.25,2460,1.0,0,2460,0,1959,276000.0
3,1.0,1270,1.0,0,1270,0,1958,276900.0
7,2.5,1940,2.0,0,1940,0,1994,280000.0
3,1.75,1230,1.0,0,1230,0,1966,280000.0
3,1.0,890,1.0,0,890,0,1954,283000.0
3,2.0,1460,1.0,0,1460,0,1995,285000.0
2,1.0,780,1.0,0,780,0,1930,286000.0
3,1.0,1110,1.0,0,1110,0,1979,299900.0
3,2.5,1870,2.0,0,1870,0,1990,299950.0001
3,1.75,1790,1.0,3,1790,0,1978,299950.0001
6,2.0,1900,1.0,0,1200,700,1964,305000.0
3,1.0,1640,1.5,0,1640,0,1942,307999.9999
3,2.5,1860,2.0,0,1860,0,2012,309620.0
2,1.0,870,1.0,0,870,0,1950,310000.0
4,2.0,1780,1.5,0,930,850,1918,314999.9999
4,2.5,2000,2.0,0,2000,0,1997,319999.9999
3,2.5,1730,2.0,0,1730,0,2014,328423.0
2,1.75,1610,1.0,0,1010,600,1941,346500.0
3,1.0,1150,1.0,0,1150,0,1932,346500.0
3,1.0,1010,1.0,0,1010,0,1947,349000.0
4,1.0,1530,1.0,0,980,550,1925,352000.0
4,2.0,2020,1.5,0,2020,0,1949,356000.0
3,2.5,1150,3.0,0,1150,0,2007,360500.0
3,2.5,1800,2.0,0,1800,0,2011,364000.0
3,2.0,1410,1.0,0,1410,0,1983,365500.0
3,2.25,1400,2.0,0,1400,0,1984,374499.9999
5,3.25,3370,2.0,0,3370,0,2001,374999.9999
3,1.75,1500,1.0,0,1500,0,1977,383000.0
4,2.25,2050,2.0,2,1770,280,1965,385999.9999
4,2.5,2340,2.0,0,2340,0,1993,390000.0
2,2.25,1350,2.0,0,1050,300,2007,395000.0
3,2.5,2180,1.0,0,1420,760,1962,400000.0
4,2.25,2000,2.0,0,1650,350,1926,402000.0
2,2.5,1590,2.0,0,1590,0,1997,409900.0
3,1.5,1250,1.0,0,1250,0,1968,410000.0
4,2.25,2100,1.0,0,1290,810,1973,418799.9999
3,2.5,2320,3.0,0,2320,0,2009,425000.0
2,1.0,1060,1.5,0,1060,0,1943,435000.0
3,1.75,2030,1.0,0,2030,0,1953,439999.9999
3,1.5,2330,1.0,0,1330,1000,1954,449999.9999
4,2.75,2310,1.0,2,1330,980,1952,449999.9999
2,1.0,1380,1.0,0,880,500,1931,450000.0
3,1.0,1970,1.0,0,1970,0,1970,454000.0
3,2.5,2420,2.0,0,2420,0,1998,481999.9999
3,1.75,1640,1.0,2,1640,0,1975,505000.0
3,2.5,1860,2.0,0,1860,0,1987,505000.0
4,2.5,1950,1.5,0,1250,700,1910,518999.9999
5,2.25,2140,1.0,0,1070,1070,1962,530000.0
4,2.75,3110,1.0,0,3110,0,1958,531500.0
4,2.5,2030,2.0,0,2030,0,1994,544000.0
3,1.75,1900,1.0,0,1900,0,1959,557500.0
2,0.75,1440,1.0,0,1200,240,1914,562100.0
3,2.5,1400,3.5,0,1400,0,2007,563499.9999
2,1.75,1670,1.0,0,1670,0,2005,565000.0
3,2.5,2380,2.0,0,2380,0,2002,573999.9999
3,2.25,1700,1.5,0,1100,600,1924,575000.0
4,2.5,2070,2.0,0,2070,0,1996,578000.0
3,2.5,1790,2.0,0,1790,0,1989,583000.0
4,2.75,2890,1.0,0,1560,1330,1973,585000.0
5,3.0,2790,1.0,3,1500,1290,1973,589950.0
4,2.75,2720,2.0,0,2720,0,2005,594000.0
3,1.75,1870,1.0,0,1870,0,1958,595888.0
4,4.0,3570,2.0,0,2860,710,2013,597326.0001
3,2.25,2680,1.0,0,1570,1110,1978,599990.0
4,2.5,2690,2.0,0,2690,0,2001,607999.9999
5,2.5,2700,1.0,0,1950,750,1955,625000.0
3,1.75,1620,1.0,0,1040,580,1947,640000.0
3,2.75,1850,1.0,2,1850,0,1953,644999.9999
4,2.75,1910,1.0,0,1420,490,1940,650000.0001
4,2.5,2180,1.5,0,1420,760,1926,657000.0001
4,1.5,1880,1.0,2,1440,440,1954,680000.0001
5,2.0,2000,1.5,2,1280,720,1908,690500.0
4,2.5,2770,2.0,0,2770,0,2004,699999.9999
3,2.5,2610,2.0,0,2610,0,1996,724999.9999
4,2.5,2490,2.0,0,2490,0,2000,725000.0001
5,2.5,2980,2.0,0,2980,0,2006,739900.0
4,2.5,3000,2.0,0,3000,0,1995,739999.9999
5,2.5,2700,1.0,0,1750,950,1967,744499.9999
4,2.5,2760,2.0,0,2230,530,1942,759999.9999
4,3.5,4000,2.0,0,4000,0,2007,762000.0
4,2.5,3920,2.0,0,3920,0,1997,770000.0001
4,2.5,3070,2.0,0,3070,0,2005,804099.9998
5,3.25,4500,2.0,4,3000,1500,1968,860000.0
4,2.75,2840,1.5,0,1960,880,1912,869999.9999
4,1.0,2550,2.0,0,2370,180,1905,890000.0
5,3.5,3100,1.0,4,1660,1440,1970,904999.9998
5,2.25,2370,2.0,0,2370,0,1981,913888.0
5,3.25,3160,2.0,2,2180,980,2005,957000.0
5,3.0,2620,2.0,0,2620,0,2009,975000.0
3,4.5,4380,2.0,3,3720,660,1968,994999.9999
4,2.25,3310,2.0,0,3310,0,1924,1140000.0
4,1.75,3990,2.0,0,3990,0,2006,1200000.0
4,3.5,3770,2.0,0,2830,940,1989,1229000.0
4,3.5,4660,2.0,2,4660,0,2003,1280000.0
5,3.5,5850,2.0,2,4670,1180,1978,1700000.0
3,1.0,1310,1.0,0,960,350,1962,150000.0
3,1.5,1220,1.0,0,1220,0,1968,177500.0
3,1.75,1260,1.0,0,1260,0,1963,200500.0
2,1.0,920,1.0,0,920,0,1950,202000.0
2,1.0,720,1.0,0,720,0,1943,210000.0
3,1.5,1090,1.0,0,1090,0,1967,214750.0001
2,1.75,1390,1.0,0,1390,0,1980,216500.0
3,1.0,1090,1.5,0,1090,0,1912,219500.0
3,1.5,1660,2.0,0,1660,0,1981,220000.0001
4,1.5,1600,1.0,0,1600,0,1959,224000.0
3,1.75,1500,1.0,0,1500,0,2014,224000.0
3,2.0,1700,1.0,0,970,730,1945,225000.0001
2,1.75,1590,1.0,0,1590,0,1972,225500.0
3,1.0,1060,1.0,0,1060,0,1956,230000.0
4,2.0,1330,1.0,0,1330,0,1942,235867.0
4,1.0,1200,1.5,0,1200,0,1933,240000.0
3,1.0,1140,1.0,0,1140,0,1981,243800.0
3,1.0,1750,1.0,0,1150,600,1956,251555.5556
3,2.0,1900,1.0,0,1900,0,1991,252500.0
4,1.0,1230,1.5,0,1230,0,1944,252750.0
3,1.0,1640,1.0,0,1090,550,1954,253500.0
5,2.0,2080,1.0,0,1740,340,1959,254000.0001
3,2.0,1470,1.0,0,1470,0,1968,254599.9999
2,1.0,930,1.0,0,930,0,1924,258125.0
3,2.5,1630,1.0,0,1120,510,1978,264269.9999
3,2.5,1650,2.0,0,1650,0,1991,268000.0
4,2.25,2600,1.0,0,1600,1000,1965,270000.0
3,1.75,1580,1.0,0,1580,0,1988,279899.9999
4,2.25,2070,2.0,0,2070,0,1977,280927.0
2,1.0,1010,1.0,0,1010,0,1975,284999.9999
4,2.25,2260,2.0,0,2260,0,1984,289659.0
3,1.75,1570,1.0,0,1080,490,1956,289987.5
3,2.25,1780,1.0,0,1780,0,1967,300000.0001
4,1.75,1530,1.5,0,1530,0,1968,302000.0
4,2.5,2430,2.0,0,2430,0,2002,310000.0
4,2.5,1940,1.0,0,1140,800,1977,315000.0
3,2.0,1550,1.5,0,1550,0,1999,320000.0
2,1.0,950,1.0,2,950,0,1948,320000.0
4,3.0,1930,1.0,0,1200,730,2006,330675.0001
3,2.5,1769,2.0,0,1769,0,2012,334887.9999
2,1.0,950,1.0,0,950,0,1941,339000.0
3,2.25,1780,2.0,0,1780,0,1987,350000.0
4,2.5,2580,2.0,0,2580,0,2005,354000.0
4,2.75,2530,1.0,0,1280,1250,1977,354950.0
3,1.5,1400,1.0,0,1400,0,1952,357250.0
3,1.5,2450,1.0,0,2450,0,1967,358000.0
5,1.75,1940,1.5,0,1940,0,1953,359000.0001
5,2.0,2280,1.5,0,2280,0,1924,365000.0
3,1.5,2380,1.0,0,1850,530,1961,370000.0001
4,2.5,3200,1.0,0,1610,1590,1970,385000.0001
3,3.25,1370,2.0,0,1100,270,2006,390000.0
4,3.0,3060,2.0,0,3060,0,2001,398999.9999
4,2.5,2220,2.0,0,2220,0,2001,405000.0
4,2.75,4230,2.0,0,4230,0,1985,405124.9999
3,2.5,2490,2.5,0,2490,0,2012,414000.0
3,1.0,1170,1.0,0,1170,0,1957,415000.0
3,2.5,2370,2.0,0,2370,0,2009,429900.0
4,2.75,2110,1.0,0,1510,600,1962,435000.0
4,2.5,2250,2.0,0,2250,0,1989,440000.0
3,1.5,2120,1.0,0,1220,900,1949,440000.0
4,2.5,2160,1.0,0,1390,770,1976,440000.0
4,1.5,1770,2.0,0,1770,0,1947,440000.0
2,1.5,1370,2.0,0,1080,290,2008,446000.0
3,1.5,1530,1.0,0,1530,0,1952,450000.0
5,2.75,2830,1.5,0,2830,0,1967,451000.0
4,2.5,2550,1.0,0,1300,1250,1961,460000.0
3,2.5,1730,1.0,0,1210,520,1969,460000.0
2,1.75,1240,1.0,0,1240,0,1924,471000.0
3,1.75,1520,1.0,0,1520,0,1983,475580.0
3,1.75,1440,1.0,0,1440,0,1983,495000.0
3,3.5,1590,3.0,0,1590,0,2010,518500.0
4,2.75,3030,2.0,0,3030,0,2011,525000.0
3,2.0,2330,2.5,0,2330,0,1987,529999.9999
3,3.0,2410,2.0,2,2410,0,1942,537000.0
5,3.0,3640,2.0,0,3640,0,2004,555000.0001
4,2.5,2480,1.0,0,1510,970,1959,560000.0001
5,3.0,3690,1.0,2,2690,1000,1960,575000.0
4,1.75,1720,1.0,0,1420,300,1975,580000.0
3,2.5,3240,2.0,0,2910,330,2004,600000.0
4,2.5,2770,2.0,0,2770,0,1989,602761.0
6,3.5,3600,2.0,0,2740,860,2004,620000.0001
3,2.0,2460,1.0,0,2460,0,1988,619999.9999
3,1.75,2430,2.0,0,1760,670,1945,626000.0
3,2.0,1660,1.0,0,970,690,1922,638000.0
3,2.5,2480,1.5,3,2480,0,1974,662999.9998
2,1.75,1950,1.0,3,1160,790,1952,669000.0
4,2.5,2670,2.0,0,2670,0,1996,669950.0
4,2.5,2150,2.0,0,2150,0,1997,677099.5651
5,3.5,2720,2.0,0,1860,860,1993,690000.0001
3,2.75,2590,2.0,0,2590,0,1993,695000.0001
3,3.25,3740,2.5,0,3100,640,1990,710000.0002
6,3.0,3110,1.5,0,1810,1300,1921,724999.9999
4,2.75,2880,1.5,0,2100,780,1912,755000.0001
3,2.5,1980,1.0,0,1980,0,1959,760000.0
4,2.5,2660,1.0,0,2660,0,1955,772650.0001
3,2.75,2850,1.0,0,1920,930,1976,775000.0
4,3.25,3060,2.0,0,2300,760,2014,782900.0
3,1.75,2080,1.0,0,2080,0,1958,800000.0003
4,2.5,2990,2.0,0,2990,0,1990,800000.0
3,2.75,2600,1.5,2,1600,1000,1929,804999.9999
4,2.75,2620,1.0,2,1310,1310,1949,815000.0001
3,2.0,2270,1.0,0,2270,0,1968,814999.9999
4,2.5,3060,2.0,0,3060,0,2006,826000.0
4,2.5,3230,1.0,0,1870,1360,1977,827000.0
4,3.5,3370,2.0,2,2470,900,2008,899999.9998
4,3.5,4040,2.0,0,4040,0,1987,910000.0003
4,3.75,3460,2.0,0,3460,0,2013,971971.0001
4,3.5,3320,1.0,2,2040,1280,1977,1025000.0
4,3.5,3450,2.0,0,3450,0,2007,1050000.0
4,3.5,3990,2.0,0,3990,0,2008,1080000.0
3,3.0,3760,2.5,3,3060,700,1910,1250000.0
4,3.0,4040,1.0,0,2020,2020,1972,1388000.0
4,2.25,3250,2.0,0,3250,0,1979,1410000.0
3,1.0,1060,1.0,0,1060,0,1959,140000.0
1,1.0,690,1.0,0,690,0,1928,167500.0
2,1.0,900,1.0,0,900,0,1905,191000.0
2,1.0,1020,1.0,0,1020,0,1940,195000.0
3,1.0,970,1.0,0,970,0,1967,209950.0
2,1.0,940,1.0,0,940,0,1926,212700.0
2,1.75,1220,1.0,0,1220,0,1972,215500.0
3,1.0,910,1.0,0,910,0,1966,221000.0
2,1.75,1110,2.0,0,1110,0,2014,229800.0
3,1.75,1010,1.0,0,1010,0,1969,230000.0
4,1.0,1390,1.0,0,1390,0,1955,233999.9999
3,1.75,1950,1.0,0,1950,0,1960,234999.9999
3,1.75,1400,1.0,0,1400,0,1998,235000.0
1,1.5,1170,2.0,0,1070,100,2007,235000.0
3,3.0,1670,1.0,0,1670,0,2014,246950.0
3,2.5,1720,2.0,0,1720,0,1998,255000.0001
3,2.25,1715,2.0,0,1715,0,1995,257500.0001
3,1.75,1650,1.0,0,1650,0,1957,259500.0
2,1.0,700,1.0,0,700,0,1922,260000.0
2,1.0,720,1.0,0,720,0,1951,275500.0
3,2.5,1630,1.0,0,1320,310,1985,279000.0
2,1.0,910,1.0,0,910,0,1948,285000.0
4,2.0,1350,3.0,0,1350,0,2008,288790.0
3,1.5,1590,1.0,0,1590,0,1956,300000.0
6,4.0,3120,2.0,2,2090,1030,1993,315000.0001
4,2.5,2570,2.0,0,2570,0,2005,320000.0
5,2.75,2400,2.0,0,2400,0,1998,327000.0
4,1.75,2440,1.0,0,1610,830,1978,330000.0
3,1.75,1780,1.0,0,1280,500,1981,342000.0
5,1.75,2330,1.0,0,1180,1150,1968,350000.0
3,1.75,2040,1.0,0,2040,0,1980,355000.0001
4,2.5,1890,2.0,0,1890,0,1996,355000.0
2,2.25,1330,2.0,0,1330,0,1985,355000.0
4,2.5,3000,2.0,0,3000,0,2002,394000.0
5,1.0,1170,1.0,0,800,370,1944,397000.0
3,2.5,2570,2.0,0,2570,0,1989,399950.0001
3,2.0,1400,2.0,0,1400,0,1981,410000.0001
3,1.0,2710,2.0,3,2710,0,1950,409999.9999
3,1.75,2410,1.0,0,1860,550,1967,415000.0
4,2.25,2300,1.0,0,1380,920,1959,416999.9999
3,2.5,2432,2.0,2,2432,0,2005,426999.9999
2,1.0,1050,1.0,0,850,200,1927,430000.0
2,1.0,1320,1.0,0,1320,0,1953,447000.0
4,2.75,2300,1.0,3,1550,750,1979,452999.9999
4,3.0,2530,2.0,0,2530,0,2013,459000.0
4,2.5,2110,1.0,0,1290,820,1985,460000.0001
4,2.25,2020,1.0,0,1380,640,1979,464900.0
4,2.5,3060,2.0,0,3060,0,2012,465000.0
4,2.5,2990,2.0,0,2990,0,1991,469899.9999
4,3.0,2370,1.5,0,1650,720,1916,471500.0
2,1.0,1500,1.0,0,1500,0,1902,479999.9999
4,2.75,2790,2.0,0,2790,0,2014,483453.0
3,2.5,2230,2.0,0,2230,0,2000,490000.0
4,1.0,1440,1.5,0,1440,0,1906,500000.0
2,1.5,1200,3.0,0,1200,0,2008,504199.9999
5,1.75,1890,1.5,0,1090,800,1906,523460.0
4,1.75,2860,1.0,0,1710,1150,1978,530000.0001
4,3.5,4150,2.0,0,4150,0,2006,549999.9999
4,2.5,2710,2.0,0,2710,0,2003,560000.0
3,1.75,1960,1.0,0,980,980,1939,561499.9999
3,3.25,2310,2.0,0,1730,580,2005,589500.0
4,1.75,2420,1.0,0,1880,540,1981,601999.9999
4,2.5,2770,2.0,0,2770,0,1997,641000.0001
5,2.5,2500,1.0,0,1490,1010,1977,661499.9999
3,2.5,2610,2.0,0,2610,0,1988,664999.9999
3,2.25,2400,1.5,0,1250,1150,1939,672500.0001
4,2.5,2540,2.0,0,2540,0,1987,677099.5652
4,2.75,3190,2.0,0,3190,0,1994,687500.0001
3,2.5,1660,2.0,2,1400,260,2002,700000.0
3,2.5,2440,2.0,0,2440,0,2003,710000.0
3,2.5,3580,1.5,0,3580,0,1990,725000.0002
3,3.0,2630,2.0,0,2630,0,2006,738000.0001
4,2.25,3190,2.0,0,2300,890,1984,750000.0001
5,2.5,3260,1.5,1,2310,950,1950,755000.0002
4,2.75,3610,2.0,0,3610,0,2014,981999.9998
4,4.25,4390,2.0,3,3320,1070,2003,1050000.0
5,2.75,3650,2.0,0,2750,900,1969,1195000.0
4,3.0,3900,1.0,4,2520,1380,1972,1619999.0
4,4.5,6640,2.0,0,6640,0,1993,1820000.0
2,1.75,1910,2.0,0,1910,0,1980,230000.0
3,1.0,1040,1.0,0,1040,0,1983,234000.0
4,1.0,1370,1.0,0,1370,0,1949,300000.0
3,1.75,1700,1.0,0,1200,500,1978,314500.0
3,1.0,1200,1.0,0,1200,0,1969,339900.0
3,1.5,1500,1.5,0,1140,360,1927,470000.0001
3,2.5,1700,1.0,0,1160,540,1998,474999.9999
5,2.5,2670,1.5,0,1620,1050,1920,585000.0
4,2.5,3130,2.0,0,3130,0,1994,597999.9999
4,2.5,2190,1.0,0,1430,760,1972,699900.0001
3,1.0,1800,1.0,0,1800,0,1957,265000.0001
5,2.75,2130,1.0,0,1300,830,1991,325000.0
3,2.0,1610,1.0,0,1610,0,1986,345000.0
3,3.5,1360,2.0,0,1240,120,2007,397000.0
4,2.75,2950,1.0,0,2120,830,1974,401999.9999
3,2.25,2120,2.0,0,2120,0,1964,834999.9998
2,1.0,930,1.0,0,930,0,1942,100000.0
2,1.0,1200,2.0,0,1200,0,1976,170000.0
2,1.0,900,1.0,0,900,0,1928,235000.0
2,1.5,1068,2.0,0,1068,0,1990,243000.0
3,2.75,1300,1.0,0,860,440,1996,245000.0
3,2.0,1440,1.0,0,1440,0,1965,250000.0
2,1.0,1320,1.0,0,940,380,1919,255000.0
3,1.75,1410,2.0,0,1410,0,1985,263000.0
2,2.0,1860,1.0,0,1260,600,1952,265000.0
3,2.5,1760,1.5,0,1760,0,1937,289950.0
2,1.0,960,1.0,0,960,0,1947,300000.0
3,1.0,1010,1.0,0,1010,0,1954,308000.0
3,2.25,2310,2.0,0,2310,0,1990,327499.9999
4,2.5,2340,2.0,0,2340,0,1997,330000.0
4,2.5,2230,2.0,0,2230,0,2002,337000.0
4,2.5,2280,2.0,0,2280,0,2006,345000.0
2,1.0,970,1.0,0,970,0,1932,345000.0
3,1.0,960,1.0,0,960,0,1958,349810.0
4,2.75,2140,2.0,0,2140,0,1993,359500.0
3,1.0,1320,1.0,0,1320,0,1982,370000.0
4,2.5,2700,2.0,0,2700,0,2001,383962.0
3,1.75,1300,1.0,0,1300,0,1968,385000.0
4,2.5,2570,2.0,0,2570,0,1992,397500.0
2,1.0,870,1.0,0,870,0,1947,406500.0
5,3.25,2820,1.5,0,2320,500,1906,408000.0
2,1.75,1510,1.0,0,1510,0,2006,419000.0
2,2.0,1090,3.0,0,1090,0,2008,427500.0
3,2.25,1370,3.0,0,1370,0,2005,433111.1111
4,2.0,1880,1.0,0,970,910,1904,435000.0
4,2.5,2290,2.0,0,2290,0,1988,436500.0
3,2.5,3180,1.0,0,1810,1370,2006,438999.9999
4,2.25,2070,1.0,0,1470,600,1977,445800.0
4,2.5,2960,2.0,0,2960,0,2005,449000.0
3,2.5,1220,2.0,0,1010,210,2008,457000.0
3,1.75,3600,2.0,0,2400,1200,1948,461000.0001
4,3.0,2440,2.0,0,1890,550,1981,480000.0
4,3.0,2330,2.0,0,1920,410,2003,490000.0
3,2.25,1470,2.0,0,1470,0,1985,491500.0
3,2.25,2090,1.0,0,1440,650,1958,491950.0
4,1.75,2120,1.0,0,1640,480,1967,492650.0001
4,3.0,3720,3.0,0,3720,0,1979,500000.0
3,2.5,2600,2.0,0,2600,0,2003,515000.0
4,2.25,1980,2.0,0,1980,0,1981,530000.0
3,1.0,1580,1.0,0,1180,400,1925,535000.0
5,2.75,2520,1.0,3,1570,950,1960,542500.0
3,2.5,1460,2.0,0,1180,280,2007,544000.0
4,1.5,2750,1.0,0,1500,1250,1958,550000.0003
3,2.25,1720,1.0,0,1220,500,1967,550000.0001
3,2.25,2070,1.5,0,2070,0,1955,560000.0001
3,2.0,1890,1.0,0,1470,420,1949,570000.0
3,2.5,3350,2.0,0,2550,800,2005,634999.9999
4,2.25,2500,1.5,0,1520,980,1940,669500.0
5,3.0,2870,1.0,0,1950,920,1964,764999.9999
4,2.5,3500,2.0,0,3500,0,2005,780000.0
3,2.5,2650,2.0,0,1830,820,1920,849999.9999
4,2.75,3220,1.5,0,2320,900,1931,880000.0001
4,2.5,3560,3.0,0,3560,0,2014,882566.0001
4,2.5,3670,2.5,0,3670,0,2007,950000.0
4,3.25,3530,2.0,0,3530,0,2007,962999.9998
4,2.75,3330,2.0,0,3330,0,1995,1095000.0
3,3.0,3790,2.0,0,2810,980,1989,1165000.0
5,3.25,4390,2.0,0,4390,0,2007,1510000.0
5,3.5,5000,2.0,3,3410,1590,2008,1730000.0
5,4.25,4830,2.5,2,3710,1120,1914,1925000.0
2,1.0,820,1.0,0,820,0,1937,102500.0
3,1.0,1200,1.0,0,1200,0,1959,165050.0
2,1.0,900,1.0,0,900,0,1979,174000.0
1,1.0,590,1.0,0,590,0,1926,202000.0
3,1.75,1170,1.0,0,1170,0,1981,205000.0
3,1.75,1400,1.0,0,1400,0,1984,217500.0
3,1.5,1620,1.0,0,1620,0,1967,219950.0
3,2.0,1770,1.0,0,1770,0,1986,240999.9999
3,2.0,1190,1.5,0,1190,0,1907,245000.0
3,1.0,950,1.0,0,950,0,1954,248000.0
3,2.25,1920,1.0,0,1300,620,1961,260000.0
2,1.0,770,1.0,0,770,0,1948,260000.0001
4,2.5,1970,2.0,0,1970,0,1987,274900.0
3,1.0,1090,1.0,0,1090,0,1962,280000.0
4,2.5,2303,2.0,0,2303,0,2006,300000.0
3,2.75,2090,1.0,0,1340,750,1987,300000.0
3,2.25,1660,2.0,0,1660,0,2001,300000.0
3,1.0,1150,1.5,0,1150,0,1927,307000.0
3,2.0,2050,1.0,0,2050,0,1993,314500.0
4,2.5,1830,2.0,0,1830,0,2003,321000.0
4,1.75,2550,1.0,0,1300,1250,1978,328950.0
3,2.5,1680,1.0,0,1080,600,1959,330000.0001
2,2.5,1050,2.0,0,950,100,2007,332888.0
3,2.25,1460,3.0,0,1460,0,2006,337000.0
2,1.0,1080,1.0,0,1080,0,1955,345000.0
3,2.0,1270,1.0,0,1270,0,1963,349500.0
3,3.5,2080,2.0,0,2080,0,2004,357500.0
4,2.5,2590,2.0,0,2590,0,1991,368112.5
2,1.0,860,1.0,0,860,0,1952,370000.0
3,1.75,2530,1.0,0,1800,730,1977,375000.0
3,1.75,1040,1.0,0,1040,0,1967,382500.0
5,2.25,3740,1.5,0,2240,1500,1958,391999.9999
4,2.5,2701,2.0,0,2701,0,2014,399895.0
3,2.0,1240,1.0,0,1000,240,1984,401000.0
4,1.0,1580,1.5,2,1580,0,1928,406000.0
4,2.5,2530,2.0,0,2530,0,2014,417838.0
3,1.5,1300,1.0,0,1300,0,1964,425000.0001
3,2.5,1950,2.0,0,1950,0,2009,425000.0001
4,2.5,2300,2.0,0,2300,0,2001,431000.0001
4,1.5,1550,1.0,0,1180,370,1963,433000.0
3,2.5,2530,2.0,0,2530,0,1993,435000.0
4,2.5,2280,2.0,0,2280,0,1994,445000.0
3,1.75,1400,1.0,0,1400,0,1963,449999.9999
2,1.0,1250,1.0,0,850,400,1929,459500.0
3,2.5,1450,2.0,0,940,510,2008,460000.0
4,3.0,2890,1.0,0,1590,1300,1945,476000.0001
3,2.25,1640,2.0,0,1640,0,1994,478000.0
3,2.25,1710,2.0,0,1710,0,1989,481999.9999
3,2.25,2440,2.0,0,2090,350,1991,485000.0002
4,1.75,1430,2.0,0,1430,0,1900,485000.0
4,2.75,2910,2.0,0,2910,0,2013,499990.0
5,3.25,3130,2.0,0,2180,950,1975,500000.0
3,2.25,1600,2.0,0,1600,0,1983,502000.0
4,2.75,2200,1.0,0,1100,1100,1962,505000.0
3,1.75,1990,1.0,0,1190,800,1977,507500.0
3,1.75,1750,2.0,0,1750,0,1934,510000.0
3,2.5,2010,2.0,0,2010,0,1994,515000.0001
3,2.5,3660,2.0,2,3260,400,1989,530000.0001
4,1.75,1420,1.5,0,1420,0,1945,534999.9999
3,1.75,2050,1.0,0,1400,650,1984,540000.0
4,2.5,2180,1.0,0,1180,1000,1968,540000.0001
4,2.5,2440,2.0,0,2440,0,1994,548000.0
3,2.5,1530,1.5,0,1010,520,1928,558653.8462
4,1.0,1410,1.5,0,1410,0,1911,563000.0
3,2.5,2200,2.0,2,2200,0,1978,580000.0001
4,1.0,1630,1.5,0,1630,0,1921,581000.0
3,2.0,1410,1.0,0,910,500,1947,590000.0
5,2.25,2980,1.0,0,1580,1400,1960,600000.0
2,2.5,2510,2.0,0,2510,0,1990,600000.0
4,1.75,1700,1.0,0,1700,0,1957,615999.9999
4,3.0,2130,1.0,0,1440,690,1948,620000.0
3,2.5,2390,2.0,0,2220,170,2008,629799.9999
4,2.5,3350,2.0,0,3350,0,2004,650000.0001
3,2.0,2570,1.0,0,1970,600,1983,660000.0
4,2.5,1820,2.0,0,1820,0,1987,673476.8182
4,2.5,2600,2.0,0,2600,0,1962,691499.9999
3,2.5,2620,2.0,0,2620,0,1998,695000.0
3,2.0,2500,1.5,0,1680,820,1922,695000.0001
3,2.5,2375,2.0,0,2375,0,2002,712000.0
3,1.75,1860,2.0,2,1860,0,1959,725000.0001
4,2.5,2840,1.0,0,1780,1060,1977,729032.0001
5,2.5,3290,2.0,0,3290,0,2004,739900.0001
4,2.25,2500,2.0,0,2500,0,1987,808000.0001
3,2.25,2880,2.0,0,2880,0,1989,819999.9999
4,2.75,3990,2.0,0,3990,0,2003,824999.9999
4,3.25,4350,1.0,0,2200,2150,2006,850000.0
5,3.5,3840,2.0,0,3840,0,2001,874999.9999
4,3.5,4080,2.0,0,4080,0,2005,920000.0001
5,5.5,5190,2.0,2,5190,0,2001,925000.0001
4,1.5,2550,2.0,0,2550,0,1910,952499.9999
4,3.5,3770,2.0,0,3770,0,2008,1020000.0
4,2.5,4570,2.0,2,4570,0,1990,1060000.0
3,2.75,3890,2.0,1,3260,630,1967,1080000.0
5,3.25,3350,2.0,0,2510,840,1997,1110000.0
4,2.5,3340,2.0,0,3340,0,1996,1150000.0
4,3.5,3400,2.5,0,2790,610,2008,1198000.0
4,3.5,4270,2.0,3,3170,1100,1937,1356925.0
2,1.0,1050,1.5,0,1050,0,1964,168333.3333
4,2.5,1780,2.0,0,1780,0,1991,175000.0
5,1.0,1590,1.5,0,1090,500,1942,185000.0001
3,2.0,1110,1.0,0,1110,0,1991,223000.0
3,3.0,2470,2.0,0,1860,610,1977,244999.9999
3,2.25,1920,1.0,0,1520,400,1965,250000.0
3,1.75,1200,1.0,0,1200,0,1984,250000.0
2,1.0,1310,1.0,0,940,370,1980,253000.0
4,2.0,2430,1.0,0,1430,1000,1960,254999.9999
4,2.25,1680,2.0,0,1680,0,2002,255000.0001
4,2.5,2050,2.0,0,2050,0,2002,256000.0
4,2.0,1620,2.0,0,1620,0,1975,260000.0
5,1.0,1870,1.0,0,1580,290,1962,262000.0
4,3.0,1940,1.0,0,1940,0,1948,265000.0
2,1.5,800,2.0,0,800,0,2008,265050.0
4,2.5,1954,2.0,0,1954,0,2005,268971.875
3,2.25,1450,2.0,0,1450,0,2010,274500.0
3,2.25,1520,2.0,0,1520,0,1992,275250.0
2,1.0,1010,1.0,0,1010,0,1947,300000.0
2,1.0,2160,1.0,0,1360,800,1968,305000.0001
3,1.0,1580,1.0,0,1010,570,1962,305000.0
3,2.5,2242,2.0,0,2242,0,2014,309780.0
2,1.0,700,1.0,0,700,0,1918,310000.0
2,1.75,1530,1.0,1,830,700,1916,318000.0
4,2.5,2120,2.0,0,2120,0,2002,329950.0
4,2.5,2105,2.0,0,2105,0,2003,330000.0
3,2.5,2390,1.0,0,1840,550,1984,339950.0
5,2.5,2450,2.0,0,2450,0,2002,345000.0001
3,1.75,1730,1.5,0,1730,0,1954,354999.9999
4,1.75,2400,1.5,0,1500,900,1927,389000.0001
4,2.5,3002,2.0,0,3002,0,2004,394500.0
3,2.5,1900,2.0,0,1900,0,1993,435000.0
3,2.0,1660,1.0,0,1260,400,1983,452999.9999
4,2.75,2620,2.0,0,2620,0,2013,475000.0001
4,2.0,2100,1.0,0,1050,1050,1962,475000.0
4,2.5,2040,2.0,0,2040,0,1963,475000.0
4,2.5,1850,2.0,0,1850,0,1981,475000.0
5,2.5,2160,2.0,0,2160,0,1998,479999.9999
3,2.0,1470,1.0,0,1470,0,1956,480000.0
3,2.25,1550,2.0,0,1550,0,1987,481015.0
4,2.5,1540,2.0,0,1540,0,2014,484998.0001
3,3.0,3700,2.0,0,3700,0,1982,488999.9999
3,1.75,1540,1.0,2,770,770,1920,512031.0
5,2.25,2570,1.0,1,1470,1100,1950,519000.0
3,1.75,2330,1.0,0,1390,940,1983,535000.0
4,2.75,2160,1.0,0,1430,730,1987,550000.0
4,2.0,1660,1.5,0,1660,0,1922,550607.1429
3,2.5,1840,1.0,0,1840,0,1978,551999.9999
3,2.5,2280,2.0,0,1880,400,2006,567500.0001
3,1.75,2680,1.0,0,1590,1090,1974,575000.0
3,2.25,1900,1.5,0,1200,700,1905,580000.0
3,1.75,1490,2.0,0,1090,400,2008,583999.9999
4,3.5,2500,2.0,0,1810,690,2008,599950.0
5,2.0,2190,1.0,0,1110,1080,1965,600000.0
4,2.25,2940,1.0,0,1520,1420,1961,605000.0001
3,2.25,2080,1.0,0,1530,550,1973,604999.9999
3,3.0,1820,3.0,0,1540,280,2006,625000.0001
4,2.5,2190,1.0,0,1410,780,1979,630000.0
3,1.75,2270,1.0,0,1370,900,1956,645000.0
4,2.0,2090,1.0,0,2090,0,1951,659000.0
5,2.5,2950,1.5,0,1720,1230,1918,660500.0
5,2.25,2900,1.0,0,1450,1450,1985,675000.0001
3,1.5,1760,2.0,0,1760,0,1922,690000.0
3,2.5,2490,2.0,0,2490,0,1993,699999.9999
4,3.0,3550,1.5,0,2180,1370,1990,719999.9998
4,2.25,2430,1.5,0,1630,800,1928,723000.0
3,3.75,2670,2.5,4,2020,650,1977,732000.0001
4,2.5,2890,2.0,0,2890,0,2005,795000.0
5,3.25,3760,2.0,0,2550,1210,1984,851000.0001
4,1.75,1880,1.5,0,1880,0,1924,859999.9999
3,4.5,3850,2.0,0,3120,730,2013,914999.9998
4,3.5,3390,2.0,0,2610,780,2014,1054690.0
3,2.5,3280,1.0,0,1680,1600,1970,1075000.0
6,4.5,3830,3.0,0,3050,780,1919,1288333.333
3,3.5,4660,2.0,4,3040,1620,1909,2147500.0
2,0.75,660,1.0,0,660,0,1912,100000.0
4,1.75,2080,1.0,0,1050,1030,1966,198000.0
4,1.0,1200,1.5,0,1200,0,1923,220000.0
3,1.75,1570,1.0,0,1570,0,1960,240000.0
3,1.75,1770,1.0,0,1770,0,1959,250000.0
2,1.5,920,2.0,0,920,0,1995,255000.0
4,2.25,2060,1.0,0,1200,860,1962,264500.0
3,1.0,1020,1.0,0,1020,0,1959,265000.0
3,1.0,1740,1.0,0,1020,720,1962,267000.0
4,2.5,1890,2.0,0,1890,0,1997,280500.0
5,2.5,2270,2.0,0,2270,0,1995,285000.0001
2,1.0,870,1.0,0,870,0,1942,287919.7826
3,2.5,1520,2.0,0,1520,0,2004,288000.0
3,1.0,1440,1.0,0,1440,0,1967,290000.0
2,1.0,1190,1.0,0,1190,0,1948,295950.0
4,1.75,2600,1.0,0,1610,990,1969,304900.0
3,1.75,1830,1.0,0,930,900,1950,312500.0
8,2.75,2790,1.0,0,1470,1320,1977,339999.9999
3,1.0,1390,1.5,0,1390,0,1908,341000.0
4,2.5,2300,2.0,0,2300,0,2001,342000.0
4,2.5,2040,2.0,0,2040,0,1999,345000.0
2,1.0,860,1.0,0,860,0,1956,370000.0001
4,2.75,2640,1.5,0,2640,0,1963,394999.9999
5,1.75,1840,1.0,2,1360,480,1948,395000.0
2,1.75,1410,1.5,0,900,510,2011,399900.0
4,2.25,2230,1.0,0,1300,930,1963,400000.0
2,2.75,1350,2.0,0,1120,230,2006,405500.0
4,2.5,1700,1.0,0,1700,0,1972,410000.0001
3,1.5,1400,3.0,0,1400,0,2007,425000.0
3,1.5,1810,1.0,0,1030,780,1958,429999.9999
3,2.5,1930,2.0,0,1300,630,2005,439990.0
3,2.5,2250,2.0,0,2250,0,2000,445838.0001
3,1.75,1530,2.0,0,1530,0,1978,474000.0
3,2.5,3316,2.0,0,3316,0,1986,490600.0
2,1.5,1930,2.0,0,1930,0,1989,509000.0
5,3.25,2740,1.0,0,1390,1350,1977,515000.0001
4,3.0,2590,2.0,0,2590,0,2014,519995.0
4,2.5,2020,2.0,0,1730,290,1943,554729.0001
3,2.5,2950,2.0,0,2950,0,2006,554950.0001
4,2.5,2230,1.0,0,1430,800,1969,565000.0001
3,1.75,1530,1.0,0,1410,120,1955,575000.0
5,3.0,2190,2.0,0,1490,700,1940,588000.0
5,2.25,3000,2.0,0,3000,0,1975,600000.0001
4,2.5,2800,1.0,0,1420,1380,1970,605000.0
3,2.5,2610,2.0,0,2610,0,2001,604999.9999
3,2.0,2300,1.0,0,1430,870,1955,609999.9999
4,2.5,2360,1.0,3,1980,380,1977,633000.0
3,2.25,1980,1.0,0,1980,0,1959,640000.0
3,4.0,2080,3.0,4,2080,0,1997,715000.0001
4,2.5,3150,2.0,0,3150,0,2002,814999.9999
4,4.25,4930,2.0,0,4930,0,2005,835000.0
3,2.5,3230,2.0,2,2430,800,1945,850000.0001
3,2.0,2470,2.0,0,2470,0,1961,850000.0
4,2.0,2490,2.0,0,2490,0,1968,939999.9999
6,2.75,2520,2.0,4,2520,0,1954,975000.0002
4,2.5,2980,2.0,0,2980,0,1989,1012000.0
3,3.25,3620,2.0,0,2730,890,2005,1015000.0
4,3.5,4370,2.0,0,4370,0,2008,1025000.0
4,5.0,4110,2.0,0,4110,0,1978,1042031.0
4,3.75,5070,2.0,0,5070,0,2000,1100000.0
4,2.5,3160,2.0,0,3160,0,1995,1127000.0
3,2.5,2780,1.5,1,2110,670,1969,1140000.0
5,2.5,3580,2.0,0,3580,0,2000,1150000.0
5,3.0,3420,2.0,0,2540,880,1952,1195000.0
3,2.5,2320,2.0,0,2320,0,2003,600000.0
3,1.75,1470,1.0,0,1030,440,1984,459500.0
3,2.5,1540,3.0,0,1390,150,1995,499000.0
4,3.0,3130,1.5,0,1750,1380,1953,671000.0
4,2.25,2110,2.0,0,2110,0,1972,672500.0
3,1.75,1480,1.0,0,1480,0,1975,395000.0
2,1.75,1990,1.0,0,1090,900,1952,454790.0
2,1.0,1060,1.0,0,820,240,1981,170500.0
2,1.0,1190,1.0,0,1190,0,1910,195000.0001
3,1.0,1100,1.0,0,1100,0,1961,199990.0
3,1.5,1180,1.0,0,1180,0,1968,209950.0001
3,1.0,960,1.0,0,960,0,1967,215000.0
3,1.0,1230,1.0,0,1230,0,1967,229500.0
3,1.0,1390,1.0,0,1390,0,1954,230000.0
3,1.75,1140,2.0,0,1140,0,2014,230000.0
2,1.0,1500,1.0,0,1190,310,1926,245000.0
4,2.25,1995,2.0,0,1995,0,1981,266000.0
3,1.0,1560,1.0,0,910,650,1948,282508.8888
4,2.0,1700,1.0,0,850,850,1955,282766.6667
3,1.75,1940,1.5,0,1940,0,1918,295000.0001
3,1.5,1640,2.0,0,1640,0,1908,295000.0
3,2.5,1520,2.0,0,1520,0,2004,296475.0
4,3.0,2200,1.0,0,2200,0,1960,299999.9999
4,2.5,2090,2.0,0,2090,0,2007,300000.0
3,1.0,930,1.5,0,930,0,1919,300000.0
3,1.75,2220,1.0,0,1270,950,1950,320000.0001
3,1.0,1120,1.0,0,1120,0,1969,320000.0
3,2.0,2250,1.5,0,2250,0,1998,328000.0
2,1.5,800,1.0,0,800,0,1951,335950.0
3,2.5,1450,2.0,0,1450,0,2004,339000.0
3,2.5,2370,2.0,0,2370,0,2014,351999.0
3,1.5,1800,2.0,0,1800,0,1931,360000.0001
4,1.75,1590,2.0,0,1590,0,1960,373000.0
2,1.5,1260,2.0,0,1260,0,2001,374000.0
3,2.5,1601,3.0,0,1536,65,2007,378000.0001
2,1.0,1190,1.0,0,1190,0,1981,382500.0
3,2.5,1920,2.0,0,1920,0,1993,391500.0
2,1.0,1290,1.0,0,1290,0,1906,406062.5
3,2.25,1450,2.0,0,1450,0,1989,410000.0
3,2.25,1620,3.0,0,1540,80,2009,430277.7778
3,1.75,2220,1.0,0,2220,0,1967,437000.0
3,2.0,1490,2.0,0,1490,0,1948,437500.0
5,1.75,1650,1.5,0,1650,0,1902,443000.0
2,2.0,1240,2.0,0,1240,0,1985,444999.9999
3,2.5,1990,2.0,0,1990,0,1993,450000.0
3,1.75,1480,1.0,0,1480,0,1971,450000.0
3,1.5,1740,1.5,0,1640,100,1920,473200.0001
5,2.5,2510,1.0,0,1490,1020,1977,475000.0001
3,2.25,1680,1.0,0,1130,550,1959,480000.0
4,2.5,2286,2.0,0,2286,0,2002,480999.9999
3,1.75,1880,1.0,0,1880,0,1984,486445.8334
3,1.0,1890,1.5,0,1390,500,1901,486895.0
3,2.5,1910,2.0,0,1910,0,2014,494814.9999
3,2.5,1720,2.0,0,1720,0,2011,500000.0
3,2.5,3030,2.0,0,3030,0,2009,509899.9999
3,2.5,1420,3.0,0,1420,0,2014,510000.0001
6,3.5,3000,1.0,0,1500,1500,1979,526999.9999
3,1.75,1320,1.0,0,870,450,1918,530000.0001
3,2.25,2590,2.0,3,2590,0,1984,538250.0
3,2.5,2040,2.0,0,2040,0,1987,542500.0
4,1.0,1660,1.5,0,1260,400,1930,548799.9999
2,2.0,1580,1.0,0,790,790,1910,558000.0
3,2.0,1640,1.0,3,820,820,1924,570000.0
4,2.5,2400,2.0,0,2400,0,1990,575000.0001
3,2.0,1860,2.0,0,1860,0,1908,588000.0
3,2.75,1830,2.0,0,1690,140,2011,593000.0
4,2.0,2530,1.5,0,1910,620,1910,631500.0
4,2.5,2690,2.0,0,2690,0,1985,644999.9999
5,2.0,2800,1.0,0,1400,1400,1963,665000.0
6,3.0,4050,2.0,0,2620,1430,1970,670000.0
5,2.5,2860,2.0,0,2860,0,1958,669999.9999
4,2.75,2330,2.0,0,2330,0,2005,679999.9999
3,3.25,2030,2.0,0,2030,0,1980,685000.0001
4,2.25,2350,2.0,0,2350,0,1977,747499.9998
4,2.0,2600,1.0,2,1400,1200,1953,779999.9999
3,2.75,2760,1.0,0,1690,1070,1967,821000.0
5,2.75,3595,2.0,0,3595,0,2014,861989.9999
4,3.25,3990,2.0,0,3990,0,2004,865999.9999
4,3.0,3040,1.5,0,2680,360,1923,870000.0
3,2.5,3540,2.0,0,3540,0,1989,888550.0
3,2.5,3870,2.0,3,3870,0,1997,1275000.0
4,3.0,5430,2.0,0,5430,0,1987,1360000.0
4,3.25,3770,2.0,0,2710,1060,1925,1450000.0
2,1.0,630,1.0,0,630,0,1930,148000.0
3,1.0,1400,1.0,0,1400,0,1968,148226.0
3,1.0,1350,1.5,0,1350,0,1942,160000.0
1,1.0,850,1.0,0,850,0,1906,165000.0
3,1.0,1040,1.0,0,800,240,1958,182805.0
3,1.0,910,1.0,0,910,0,1968,190000.0
3,1.0,1320,1.5,0,1320,0,1912,201500.0
3,1.0,1180,1.0,0,1180,0,1967,205000.0
3,2.0,960,1.0,0,960,0,1949,210000.0
3,1.0,1070,1.0,0,1070,0,1949,210000.0
3,1.75,1200,1.0,0,1200,0,1968,228949.9999
2,1.0,770,1.0,0,770,0,1948,229629.5
3,1.5,1460,1.0,0,1460,0,1966,232000.0
2,1.0,1020,1.0,0,1020,0,1939,235000.0
5,2.5,2340,1.0,0,1670,670,1967,235500.0
3,2.5,1600,2.0,0,1600,0,1992,245000.0
2,1.5,1090,2.0,0,1090,0,1982,248999.9999
3,1.75,1140,1.0,0,1140,0,1983,249999.9999
4,2.5,2530,2.0,0,2530,0,1993,252979.9999
3,1.75,1550,1.0,0,1050,500,1976,255000.0001
3,1.0,1400,1.5,0,1400,0,1944,267000.0
3,2.5,2538,2.0,0,2538,0,2013,289373.3076
3,1.5,1520,1.0,0,1520,0,1959,292600.0
3,2.25,1910,2.0,0,1910,0,2009,293000.0
4,2.5,2200,2.0,0,2200,0,1998,300000.0
3,1.0,1150,1.0,0,1150,0,1960,300000.0
4,2.5,1920,2.0,2,1920,0,1994,308950.0
2,1.0,1080,1.0,0,720,360,1919,315000.0
3,3.25,1450,2.0,0,1180,270,2013,320000.0
2,1.0,810,1.0,0,810,0,1941,325000.0
2,1.0,800,1.0,0,800,0,1953,325000.0
3,1.0,1060,1.0,0,1060,0,1968,326500.0
3,2.25,2220,1.0,0,1330,890,1993,330000.0001
3,2.25,2120,1.0,0,1720,400,1979,332000.0
4,2.5,2250,2.0,0,2250,0,2014,333489.9999
3,2.25,2760,1.0,0,2760,0,1969,336000.0
3,2.25,2120,1.0,0,2120,0,1997,340000.0001
4,2.75,3000,2.0,0,3000,0,2005,354999.9999
2,1.75,1210,2.0,0,1210,0,2014,357562.0
5,3.0,1810,2.0,0,1810,0,1998,362000.0
4,1.75,2100,1.0,0,1030,1070,1964,368000.0001
3,1.75,1570,2.0,0,1570,0,1982,370000.0
3,1.0,1650,1.0,0,980,670,1954,371500.0
3,1.75,1660,1.0,0,1130,530,1976,375000.0
3,2.5,2860,2.0,0,2860,0,1990,378499.9999
4,2.5,1984,1.0,0,1564,420,1962,380000.0
4,2.5,2620,2.0,0,2620,0,1991,380680.5555
3,2.25,2090,1.0,0,2090,0,1961,383000.0
3,1.75,1180,1.0,0,1180,0,1967,390000.0001
3,1.75,1880,1.0,0,940,940,1945,396166.6667
4,1.75,1360,1.5,0,1360,0,1928,399500.0
4,2.5,2560,2.0,0,2560,0,2006,410000.0
4,2.25,2060,1.0,0,1220,840,1963,409999.9999
3,2.0,1320,1.5,0,1320,0,1920,410000.0001
4,1.75,1920,2.0,0,1920,0,1970,415000.0001
3,2.0,1550,1.0,0,830,720,1942,429999.9999
4,2.75,2230,1.0,0,1320,910,1998,435000.0001
4,2.5,2150,2.0,0,2150,0,2010,435000.0
2,2.0,1270,3.0,0,1270,0,2000,438000.0
4,2.25,2570,2.0,0,2570,0,1980,438999.9999
4,2.5,2680,2.0,0,2680,0,2013,449990.0001
4,3.5,3440,2.0,0,3440,0,2002,455000.0
4,2.5,1910,1.0,0,1910,0,1921,458400.0
3,1.5,1830,1.0,0,1830,0,1962,468000.0
4,2.75,2530,2.0,0,2530,0,1997,469949.9999
3,1.0,1340,1.0,0,1340,0,1955,479000.0001
2,1.0,1060,1.0,0,860,200,1924,480000.0
4,2.25,1900,1.0,0,1370,530,1977,485000.0001
3,2.5,1810,2.0,0,1810,0,1992,513000.0001
2,1.5,1920,1.0,0,960,960,1912,517000.0
5,2.5,2820,1.0,0,1550,1270,1968,527699.9999
2,2.5,1785,2.0,0,1595,190,1975,530000.0
3,1.75,1070,1.0,0,1070,0,1966,542000.0
3,3.5,2490,2.0,0,1720,770,2005,550000.0
3,2.25,1820,2.0,0,1820,0,1984,557500.0
4,2.25,1950,1.0,0,1330,620,1968,560000.0
4,1.75,2790,1.0,2,1450,1340,1956,568000.0
4,2.5,2130,1.0,0,1490,640,1980,580000.0
3,2.25,1940,1.0,0,1520,420,1987,580000.0001
4,2.5,2630,2.0,0,2630,0,1999,584999.9999
2,2.0,1570,1.0,0,1570,0,2006,592350.0
3,2.0,2560,1.0,0,1330,1230,1987,599000.0
3,2.25,1900,1.5,0,1440,460,1969,600000.0
4,2.5,2250,2.0,0,2250,0,1991,600000.0
3,1.75,2050,1.0,0,2050,0,1973,623000.0
2,2.5,2290,2.0,0,2290,0,2005,629999.9999
4,2.5,2850,2.0,0,2850,0,1987,645000.0
4,3.0,3720,1.0,0,1880,1840,2003,650000.0003
3,2.75,2830,2.0,0,2830,0,2012,673000.0
4,2.5,2610,2.0,0,2610,0,2006,674600.0
4,2.5,3220,2.0,0,3220,0,1991,690000.0
5,2.75,2510,1.0,1,1600,910,1975,695500.0001
4,3.0,3580,2.5,0,2370,1210,1991,711599.9999
4,2.25,2410,2.0,0,2410,0,1965,720000.0001
4,2.75,3090,2.0,0,3090,0,2010,760005.0
4,4.0,3010,2.0,0,3010,0,2004,765000.0
2,2.5,2560,2.0,0,1690,870,1901,780000.0
4,3.5,5270,2.0,0,3440,1830,2004,781999.9999
3,2.5,3420,1.0,0,1750,1670,1987,789900.0
2,2.75,2700,1.0,0,2700,0,2007,809999.9999
4,3.5,3370,2.0,0,2750,620,2007,811999.9999
3,2.75,3176,2.0,3,2726,450,1985,819000.0001
3,2.5,3180,2.0,0,3180,0,1978,900000.0
3,2.5,3480,1.0,0,1750,1730,1941,950000.0
5,2.75,3500,2.0,2,2950,550,1927,970000.0001
4,2.5,3130,2.0,0,3130,0,2013,998999.9999
4,3.75,4740,2.0,0,4740,0,1991,1049000.0
2,2.0,2360,1.5,0,2360,0,1997,1087500.0
4,2.5,3180,1.0,0,2390,790,1978,1115000.0
3,2.25,2790,1.0,3,2790,0,2006,1131000.0
3,2.5,3830,2.0,0,3830,0,1991,1150000.0
4,3.5,3960,2.0,0,2850,1110,2006,1195000.0
4,3.5,3150,2.0,0,3150,0,2014,1205000.0
4,5.25,6500,2.0,0,5180,1320,2001,2458000.0
3,1.0,960,1.0,0,960,0,1970,137124.0
3,0.75,490,1.5,0,490,0,1959,149999.9999
4,1.0,1600,1.0,0,1600,0,1966,154950.0
2,1.0,840,1.0,0,840,0,1952,187000.0
3,2.5,1610,2.0,0,1610,0,1994,210614.2856
3,1.75,1770,1.0,0,1770,0,1959,215000.0001
4,1.5,1860,1.5,0,1860,0,1920,215000.0
3,1.0,1200,1.0,0,1200,0,1967,215000.0
3,1.0,990,1.0,0,990,0,1943,226550.0
4,2.25,2010,1.0,0,1170,840,1979,229000.0
3,1.5,1940,1.0,0,1140,800,1969,232500.0
2,1.75,1460,1.0,0,1460,0,1987,237950.0
3,1.0,990,1.0,0,990,0,1960,250000.0
4,1.75,1120,1.0,0,1120,0,1966,252000.0
4,2.5,1660,1.0,0,1660,0,1978,270000.0
4,2.0,2030,2.0,0,2030,0,1944,275000.0
3,1.0,1200,1.0,0,1200,0,1954,275000.0
4,1.75,1880,1.0,0,1130,750,1960,284000.0001
3,1.5,1500,1.0,0,1500,0,1957,284000.0
5,1.5,1730,1.0,0,1010,720,1962,286999.9999
3,1.5,1950,1.0,0,1950,0,1959,290000.0
2,1.0,800,1.0,0,800,0,1953,295000.0
3,2.5,1460,2.0,0,1460,0,2000,299880.0
4,1.75,1820,1.0,0,1190,630,1926,300000.0
3,1.5,1800,1.0,0,1800,0,1966,305000.0
3,1.0,1450,1.0,0,1010,440,1969,306000.0
3,1.75,1510,1.0,0,1510,0,1954,308166.6668
3,2.25,1980,1.0,0,1300,680,1963,309000.0
3,1.5,1460,1.0,0,1460,0,1952,310000.0
3,1.0,1370,2.0,0,1370,0,1930,335500.0001
3,1.0,1600,1.0,0,1600,0,1958,340000.0
3,2.5,1590,2.0,0,1590,0,2000,356000.0
3,1.5,1550,1.0,0,1080,470,1978,359000.0
3,2.25,1390,3.0,0,1390,0,2007,374950.0
3,2.5,1530,2.0,0,1530,0,1986,379000.0
4,2.75,1970,1.0,0,1970,0,1961,395000.0001
2,1.0,930,1.0,0,930,0,1940,395000.0
5,2.75,1970,1.0,0,1320,650,1986,399949.9999
3,2.0,1760,1.0,0,1760,0,1967,400000.0001
5,3.25,3320,2.0,0,2480,840,1999,409124.0
3,1.75,1660,1.0,0,830,830,1980,410000.0
4,3.5,3360,2.0,0,2450,910,1990,412000.0
4,1.5,1840,1.5,0,1840,0,1950,414999.9999
3,2.5,3010,2.0,0,3010,0,2009,416904.1668
2,1.0,1320,1.0,0,1020,300,1939,425000.0
4,2.5,2550,2.0,0,2550,0,2009,435000.0
3,1.5,1270,3.0,0,1270,0,2007,440000.0001
3,2.25,1920,2.0,0,1920,0,1989,443000.0
4,2.5,1980,2.0,0,1980,0,1974,463000.0
4,2.5,2100,1.0,0,1240,860,1976,468000.0
4,2.25,2380,2.0,0,1530,850,1979,470000.0
5,2.75,2550,1.0,0,1390,1160,1967,480000.0
4,2.5,3560,2.0,0,3560,0,1988,486000.0
4,2.5,2540,2.0,0,2540,0,2005,486999.9999
3,2.0,2660,1.0,0,2660,0,1964,494999.9998
2,1.75,1350,1.0,0,1350,0,2008,498800.0
3,1.75,2140,1.0,0,1490,650,1950,506999.9999
4,2.5,3670,2.0,0,3670,0,2005,524999.9999
4,2.75,2910,1.0,0,1640,1270,1985,524999.9999
4,1.75,1710,1.0,0,1710,0,1955,524999.9999
3,2.5,1790,2.0,0,1790,0,2010,530000.0001
3,2.5,1460,2.0,0,1460,0,1983,534333.3333
3,2.5,2760,2.0,0,2760,0,2002,545000.0
4,1.75,2150,1.0,0,1110,1040,1966,550000.0
3,2.0,1970,2.0,3,1270,700,1929,550000.0
4,1.0,1440,1.5,0,1440,0,1924,550000.0001
3,2.5,1960,2.0,0,1960,0,2002,560000.0
4,2.5,2570,2.0,0,2570,0,1990,561000.0001
3,2.5,2500,2.0,0,2500,0,1990,565000.0
3,3.25,2220,1.5,0,1770,450,1929,569000.0001
6,3.75,4000,2.0,2,3080,920,2004,570000.0
3,1.75,1850,1.0,0,1020,830,1909,580000.0
3,2.5,2600,2.0,1,2600,0,1998,582999.9999
3,2.5,2650,1.0,0,1680,970,1975,590000.0
4,2.5,2720,2.0,0,2720,0,1989,594950.0
4,3.25,3730,2.0,0,2760,970,2013,594999.9999
7,2.5,2580,1.0,0,1880,700,1901,599000.0
3,3.25,1830,3.0,0,1830,0,2014,599950.0
3,2.5,2630,2.0,0,2630,0,2001,610000.0001
3,2.0,2250,1.0,0,1500,750,1964,624799.9999
4,1.0,1600,1.5,0,1600,0,1946,625000.0001
3,1.75,1710,1.0,0,1710,0,1986,630000.0
4,2.5,3080,2.0,0,3080,0,1997,634999.9999
4,2.75,3510,2.0,0,3510,0,2014,659950.0001
4,2.5,2510,2.0,0,2510,0,2002,659999.9999
4,2.75,2100,1.5,0,1780,320,1928,679000.0
3,2.0,1780,1.0,0,980,800,1925,680000.0001
4,2.75,3710,2.0,0,3710,0,1999,692500.0
4,3.5,3650,2.0,0,2550,1100,1996,696000.0
4,2.5,3350,2.0,0,3350,0,1985,720500.0
4,3.25,4280,2.0,0,3050,1230,2002,734950.0002
2,2.25,2290,1.0,0,2290,0,2007,737000.0
3,1.75,2320,2.0,0,2320,0,1935,737499.9999
4,2.5,3360,2.0,0,3360,0,1997,739999.9999
2,2.5,2150,1.0,0,2150,0,2010,741499.9999
3,2.75,2820,2.0,0,2820,0,2008,749000.0001
4,2.75,2700,2.0,0,2100,600,1910,749000.0001
4,2.75,2910,1.0,0,2210,700,1957,749950.0
4,2.5,3020,2.0,0,3020,0,2004,750000.0
4,1.75,2100,1.0,0,1340,760,1975,759000.0
4,2.25,3300,3.0,0,3300,0,2014,760000.0001
4,1.75,2000,1.0,4,1000,1000,1958,810000.0
3,2.0,2783,2.0,0,2783,0,1910,840000.0001
5,4.5,4030,2.0,0,4030,0,2000,989000.0
4,3.5,4440,2.0,0,4440,0,2003,1037000.0
4,3.75,4260,2.0,0,4260,0,2008,1065000.0
5,3.5,5430,2.0,2,4010,1420,2007,1240000.0
4,3.5,3550,1.0,2,2260,1290,1999,1355000.0
6,4.5,4230,2.0,3,2360,1870,1916,1465000.0
5,5.25,4830,2.0,1,3930,900,1952,1681000.0
5,4.75,5780,2.0,0,4260,1520,2006,2321000.0
4,2.0,2090,1.0,0,1070,1020,1974,203400.0
3,2.5,1490,2.0,0,1490,0,1990,220600.0
3,1.75,1580,1.0,0,1180,400,1993,263000.0
3,2.5,1530,2.0,0,1530,0,1991,265000.0
3,2.25,1720,2.0,0,1720,0,1983,290256.0
4,2.5,2800,2.0,0,2800,0,1993,350000.0
4,1.0,1170,1.5,0,1170,0,1959,350000.0
3,2.5,2110,2.0,0,2110,0,1989,354999.9999
4,2.5,2380,2.0,0,2380,0,2005,359999.9999
3,1.0,1470,1.0,0,1470,0,1953,410000.0
4,2.5,2700,2.0,0,2700,0,1998,426499.9999
4,2.0,1560,1.0,0,1560,0,1968,439000.0
4,1.75,1520,1.0,0,1520,0,1967,499950.0
2,1.0,1240,1.0,0,1240,0,1962,504999.9999
2,2.0,2930,1.0,2,1680,1250,1980,545000.0
4,2.75,2600,1.0,0,1580,1020,1976,610000.0002
4,2.0,1840,1.0,0,920,920,1942,639000.0
3,2.0,2320,1.0,0,1510,810,1956,657500.0
3,2.5,2700,2.0,0,1280,1420,2003,670000.0
4,2.5,3340,2.0,2,3340,0,1999,720000.0
2,1.75,1950,1.0,0,1010,940,1919,725000.0
3,2.5,2820,2.0,0,2820,0,2004,735000.0001
6,2.75,2980,1.5,0,2480,500,1916,774999.9999
3,2.75,2220,2.0,0,1700,520,1914,800000.0
4,3.5,3840,2.0,0,3840,0,1998,840000.0002
5,2.0,2310,1.5,0,2310,0,1966,850000.0
4,2.5,3360,2.0,0,3360,0,1994,879000.0001
6,2.5,2640,2.0,0,1760,880,1922,879999.9999
5,4.25,6070,2.0,0,6070,0,1999,1550000.0
