number of rooms,security level of the community,residence space,noise level,view,aboveground space ,basement space,building year,cost rank
5,2.5,2820,2.0,0,2820,0,1979,3
2,1.0,1210,1.0,0,1210,0,1949,1
4,2.5,2200,2.0,0,2200,0,1987,1
3,1.5,1200,1.0,0,1200,0,1965,1
3,1.75,1370,1.0,0,1370,0,1987,1
4,2.0,1480,1.0,0,1480,0,1974,1
3,1.5,1180,1.0,0,1180,0,1983,1
3,2.5,2090,1.0,0,1360,730,1987,1
3,3.0,1850,1.0,0,1090,760,1992,1
2,2.5,1630,2.0,0,1280,350,2009,1
3,2.5,2540,2.0,0,2540,0,2006,2
2,1.0,850,1.0,0,850,0,1950,2
3,1.0,1160,1.0,0,1160,0,1968,2
3,2.25,1580,1.0,0,1580,0,1978,2
2,2.0,1350,1.0,0,1350,0,1976,2
3,2.0,1930,1.0,0,1930,0,1966,2
3,1.0,1090,1.0,0,1090,0,1955,2
4,3.0,3110,2.0,0,3110,0,1997,2
4,1.75,1560,1.0,0,1560,0,1967,2
3,3.25,1320,2.0,0,1040,280,2008,2
3,2.0,1960,1.0,2,1650,310,1957,2
3,2.5,1930,2.0,0,1930,0,1996,2
3,1.5,1570,1.0,0,1570,0,1956,2
3,2.25,2000,1.0,0,1000,1000,1963,2
4,1.5,1920,1.0,0,1070,850,1954,2
4,1.0,1450,1.0,0,1450,0,1954,2
3,2.5,1770,3.0,0,1600,170,2007,2
3,2.25,1970,2.0,0,1970,0,1977,2
3,2.5,1770,2.0,0,1770,0,1990,2
4,2.25,2160,1.0,0,1080,1080,1966,2
3,2.5,1270,3.0,0,1270,0,2001,2
3,2.5,2680,2.0,0,2680,0,2013,2
3,1.75,1710,1.0,0,1710,0,1948,2
5,2.5,2210,1.0,0,1460,750,1976,2
4,2.5,2710,2.0,0,2710,0,1989,2
4,1.75,2190,1.0,2,2190,0,1968,2
4,1.75,1600,1.0,0,1130,470,1959,2
4,2.5,2860,2.0,0,2190,670,2004,2
3,1.75,2910,1.5,0,2910,0,1979,3
4,2.5,1940,1.0,0,1140,800,1976,3
4,2.5,3310,2.0,0,3310,0,2012,3
3,1.75,2330,1.0,0,1970,360,1980,3
3,2.5,3240,2.0,2,3240,0,1995,3
4,2.5,2730,2.0,0,2730,0,1991,3
3,1.75,2360,1.0,0,1360,1000,1948,3
4,3.25,2730,1.0,0,1560,1170,2007,3
4,2.5,2820,2.0,0,2820,0,2014,3
3,2.25,1750,2.5,0,1470,280,2005,3
4,2.75,2710,2.0,0,2710,0,2000,3
4,2.0,1520,1.5,0,1520,0,1945,3
4,2.0,1820,1.5,1,1640,180,1945,3
4,2.25,2200,1.5,0,1300,900,1920,3
3,2.5,2390,1.0,2,1440,950,1955,4
3,1.75,2240,2.0,0,1550,690,1923,4
5,3.25,3660,2.0,2,3660,0,2006,4
3,2.5,2600,1.0,0,1700,900,1951,4
3,2.0,2710,1.5,0,1880,830,1929,4
4,2.5,3310,2.0,0,3310,0,2001,4
5,2.75,2910,1.5,0,2910,0,1939,4
3,1.0,1010,1.0,0,1010,0,1973,2
3,2.5,1650,1.0,0,1130,520,1986,2
4,2.75,2920,2.0,0,2920,0,2012,3
4,2.5,2530,2.0,2,2010,520,1990,2
3,2.5,2200,1.0,0,1570,630,1988,2
4,2.0,2280,1.0,0,1140,1140,1900,3
2,2.5,2680,1.0,0,2680,0,2004,4
3,2.5,2850,2.0,0,1990,860,1980,4
2,1.0,810,1.0,0,810,0,1944,1
4,1.5,1240,1.0,0,1240,0,1971,1
2,1.0,1200,1.0,0,1200,0,1958,1
3,1.75,1920,1.0,0,1000,920,1984,1
3,2.0,1550,1.0,0,1550,0,1958,1
3,1.0,1450,1.0,0,1450,0,1953,1
3,2.0,1050,1.0,0,1050,0,1986,2
4,2.75,2310,2.0,0,2310,0,2006,2
3,2.5,1880,2.0,0,1880,0,1994,2
4,2.5,2370,2.0,0,2370,0,1998,2
2,1.0,1140,1.5,0,1140,0,1949,2
5,1.0,1120,1.5,0,1120,0,1962,2
2,1.5,1160,2.0,0,1160,0,2001,2
3,3.0,1571,3.0,0,1571,0,2008,2
4,1.75,1970,1.0,0,1140,830,1960,2
5,2.5,3090,1.0,0,1750,1340,1968,2
3,2.5,2230,2.0,0,2230,0,1954,2
2,1.75,2110,1.0,0,2110,0,1948,2
2,1.0,840,1.0,0,840,0,1955,2
2,3.0,1410,2.0,0,1140,270,2006,2
3,2.25,1410,3.0,0,1410,0,2005,2
3,2.25,1800,1.0,0,1360,440,1978,2
3,2.25,1620,2.5,0,1540,80,2010,2
3,2.5,1408,3.0,0,1408,0,2005,2
3,2.0,1410,1.5,0,1410,0,1930,2
2,2.5,1590,2.0,0,1590,0,2014,2
5,2.0,1840,1.0,0,1540,300,1942,2
4,2.0,1480,1.5,0,1480,0,1928,2
3,2.5,3040,2.0,0,3040,0,2007,2
4,3.0,2340,1.0,0,1340,1000,1979,2
4,1.75,2010,1.0,0,1470,540,1977,2
4,2.5,2910,2.0,0,2910,0,2006,2
4,1.0,2070,1.0,0,1160,910,1963,3
3,2.5,1790,2.0,0,1790,0,2010,3
3,1.75,1560,1.0,0,780,780,1944,3
5,2.75,2740,1.0,0,1370,1370,1960,3
4,2.5,2910,2.0,0,2910,0,2008,3
3,2.5,1940,2.0,0,1940,0,2009,3
3,2.5,1900,2.0,0,1900,0,1987,3
3,2.25,2010,1.0,0,1330,680,1975,3
2,1.0,2540,1.0,0,1320,1220,1942,3
2,1.0,1770,1.5,0,1520,250,1949,3
3,1.75,1670,1.0,0,1670,0,1976,3
3,1.75,1880,1.0,0,1040,840,1945,3
4,1.75,2300,1.0,0,1960,340,1977,3
3,2.0,1800,1.0,0,1080,720,1942,3
4,2.25,1990,1.0,0,1210,780,1973,3
4,2.5,2440,2.0,0,2440,0,2014,3
3,1.5,2160,1.0,2,1400,760,1949,3
3,2.5,1680,3.0,0,1680,0,1909,3
3,2.5,2490,2.0,0,2490,0,2003,4
4,2.5,2450,2.0,0,2450,0,2013,4
4,2.5,3180,2.0,3,3180,0,2000,4
4,2.5,2800,1.0,0,1660,1140,1963,4
4,2.5,2120,1.0,0,1620,500,1960,4
3,2.0,2350,1.5,0,1810,540,1939,4
4,2.5,2730,2.0,2,2730,0,1996,4
3,2.5,3240,2.0,0,3240,0,1994,4
5,2.5,3180,2.0,0,3180,0,1990,4
6,1.75,2920,2.5,0,2780,140,1908,4
4,2.5,3400,2.0,0,3400,0,2007,4
4,3.0,2170,2.0,0,1610,560,1982,4
4,3.0,3690,2.0,0,3690,0,1998,4
4,4.25,4420,2.0,0,3410,1010,2006,4
5,3.5,4490,2.0,0,3200,1290,2006,4
5,2.75,3190,1.0,3,1690,1500,1976,4
5,3.5,4010,2.0,1,2850,1160,1971,4
7,8.0,13540,3.0,4,9410,4130,1999,4
3,1.5,1420,1.0,0,1420,0,1962,1
3,1.0,1010,1.0,0,1010,0,1954,1
3,1.5,800,1.0,0,800,0,1959,1
3,1.75,1690,1.0,0,1060,630,1976,1
3,1.75,1850,1.0,0,1320,530,1979,1
2,1.0,900,1.0,0,900,0,1952,1
3,1.75,1490,1.0,0,1010,480,1975,1
3,1.0,1050,1.0,0,1050,0,1954,1
3,2.5,1650,2.0,0,1650,0,1998,1
3,1.75,1580,1.0,1,1100,480,1962,1
3,2.25,1970,1.0,0,1180,790,1967,1
3,1.75,1630,1.0,0,1630,0,1971,1
4,2.5,2000,2.0,0,2000,0,2003,1
3,2.25,1980,1.0,0,1560,420,1974,1
4,2.0,1300,1.0,0,1300,0,1950,2
3,1.0,1510,1.0,0,860,650,1940,2
4,2.5,1890,1.0,0,980,910,1980,2
2,1.0,720,1.0,0,720,0,1942,2
4,2.5,2331,2.0,0,2331,0,2007,2
3,1.0,1110,1.0,0,1110,0,1956,2
3,1.0,1350,1.0,0,860,490,1947,2
4,2.0,2680,1.0,0,2680,0,1965,2
3,2.25,1640,1.0,0,1140,500,1963,2
3,1.5,1310,1.0,0,1310,0,1950,2
3,1.5,1410,1.0,0,1410,0,1961,2
3,2.0,1270,3.0,0,1270,0,2006,2
4,1.75,1500,1.0,0,1000,500,1955,2
3,1.75,1900,1.0,0,1280,620,1982,2
3,1.0,1230,1.0,0,1230,0,1962,2
5,3.75,2890,1.0,0,1310,1580,2006,2
3,1.75,1260,1.0,0,1260,0,1966,2
4,2.0,1440,1.0,0,1200,240,1971,2
4,1.75,1840,1.0,0,960,880,1958,2
4,2.0,1520,1.0,0,1520,0,1967,2
3,3.5,3020,2.0,0,2080,940,1954,2
5,2.5,2240,1.0,0,1340,900,1978,2
6,3.0,3470,1.5,0,3470,0,1924,2
4,2.5,2740,2.0,0,2740,0,1995,2
2,1.75,1660,1.0,0,1160,500,1942,2
3,2.0,1420,1.5,0,1420,0,1905,2
5,2.0,2020,1.5,0,2020,0,1938,2
2,1.75,1170,1.0,0,740,430,1903,2
3,2.5,1480,3.0,0,1480,0,2006,3
4,2.5,2000,2.0,0,2000,0,1996,3
3,2.5,1790,2.0,0,1790,0,1989,3
3,1.5,1430,1.0,0,1430,0,1956,3
3,2.5,2460,2.0,0,2460,0,1980,3
3,2.5,2970,1.0,0,1770,1200,1995,3
5,2.5,2910,1.0,0,1690,1220,1964,3
5,2.75,1800,1.5,0,1400,400,1926,3
3,2.5,1850,2.0,0,1850,0,1991,3
3,2.0,2000,2.0,0,2000,0,1916,3
5,2.25,3040,2.0,0,3040,0,1984,3
4,3.0,3100,2.0,0,2400,700,1996,3
3,1.75,2130,1.0,2,1170,960,1954,3
4,3.25,3569,2.0,0,3569,0,2013,3
4,2.25,2260,2.0,0,1400,860,1977,3
4,2.5,2110,2.0,0,2110,0,1987,3
4,2.5,2150,2.0,0,2150,0,1985,3
4,3.0,2450,1.0,0,1580,870,1967,3
4,2.0,2060,1.0,0,1030,1030,1949,3
3,1.5,1630,1.0,1,1160,470,1940,3
4,3.5,3380,2.0,0,3380,0,2000,3
4,2.5,3030,2.0,0,3030,0,1999,3
4,2.5,3200,2.0,0,3200,0,1998,4
4,2.5,2290,2.0,0,2290,0,1988,4
4,2.5,3880,2.0,0,3880,0,1987,4
4,2.5,3040,2.0,0,3040,0,2008,4
4,2.0,3740,2.0,0,3740,0,2000,4
3,2.5,2690,3.0,0,2690,0,2014,4
4,2.75,3370,1.0,3,1970,1400,1970,4
4,2.25,3490,2.0,0,2280,1210,1928,4
4,3.25,3760,1.5,0,2400,1360,1950,4
5,4.0,4510,2.0,0,4510,0,1969,4
2,1.0,1040,1.0,0,1040,0,1912,1
3,2.0,1570,1.0,0,1570,0,1952,1
4,1.0,1490,1.0,0,1490,0,1969,1
3,1.5,1380,1.0,0,1380,0,1960,1
3,1.75,1640,1.0,0,1130,510,1988,1
3,2.5,1920,2.0,0,1920,0,1988,1
3,2.0,1410,1.0,0,1410,0,1985,1
3,1.5,1260,2.0,0,1040,220,2005,1
3,1.0,1400,1.0,0,1400,0,1944,1
4,1.75,1720,1.0,0,1720,0,1960,1
3,1.0,1110,1.0,0,1110,0,1952,1
1,1.0,1100,1.0,0,820,280,1947,1
3,1.75,1250,1.0,0,1250,0,1994,1
5,2.25,2060,1.0,0,1030,1030,1962,1
3,2.5,1600,2.0,0,1600,0,1993,1
3,2.5,1600,2.0,0,1600,0,2000,1
3,1.75,1840,1.0,0,1220,620,1974,2
3,1.75,2190,1.0,0,2190,0,1967,2
3,1.75,1870,1.0,0,1870,0,1957,2
3,1.0,1040,1.0,0,1040,0,1968,2
3,3.0,1680,3.0,0,1680,0,2014,2
3,2.25,1630,2.0,0,1630,0,1985,2
3,1.0,1010,1.0,0,1010,0,1981,2
5,2.5,2420,1.0,2,1620,800,1978,2
2,1.0,820,1.0,0,820,0,1944,2
5,2.75,2410,1.0,0,1410,1000,2008,2
3,2.5,1830,2.0,0,1830,0,1990,2
2,1.0,1640,1.0,0,840,800,1978,2
5,1.75,3000,1.0,0,1500,1500,1958,2
3,2.25,1660,1.0,0,1660,0,1961,2
4,2.75,2140,1.0,0,1320,820,1968,2
4,3.0,1830,2.0,0,1830,0,1991,2
3,2.25,1606,3.0,0,1606,0,2009,2
3,2.25,1770,2.0,0,1770,0,1977,2
2,2.5,1150,3.0,0,1150,0,2008,2
2,2.0,1350,1.0,0,1350,0,2003,2
3,1.75,1500,1.0,0,1060,440,1947,2
3,2.5,1600,2.0,0,1600,0,2013,2
3,2.0,1760,2.0,0,1760,0,1985,2
4,2.5,2180,1.0,0,2180,0,1968,2
3,2.0,1610,1.0,0,1010,600,1917,2
4,2.5,3305,1.5,0,2245,1060,1922,2
4,2.75,2656,2.0,0,2656,0,2014,2
3,2.5,1940,1.0,0,1940,0,1987,2
3,2.5,2280,2.0,0,1880,400,2006,3
3,2.75,1540,1.0,0,1210,330,1980,3
4,2.5,2430,2.0,0,2430,0,2003,3
3,1.75,1580,1.0,1,1210,370,1967,3
3,2.25,1170,3.0,0,1170,0,2014,3
2,2.0,1550,1.5,0,1550,0,1900,3
3,1.0,1340,1.0,0,1080,260,1910,3
7,5.75,3700,2.0,1,3700,0,1948,3
3,3.0,4120,2.0,2,3180,940,1994,3
3,2.0,1860,1.0,0,1860,0,1985,3
3,2.0,2350,1.5,0,1780,570,1929,3
4,2.0,1650,1.0,0,1650,0,1955,3
4,2.0,2510,1.0,0,1280,1230,1961,3
3,1.75,1960,1.0,0,1090,870,1920,3
9,4.5,3830,2.5,0,2450,1380,1938,3
3,2.5,2460,1.0,0,1860,600,1977,3
3,2.5,2030,2.0,0,2030,0,1988,3
2,2.25,2550,1.0,0,1720,830,2011,3
3,3.0,2270,2.0,0,2130,140,2002,3
3,2.5,3240,2.0,0,3240,0,1991,3
4,2.5,2650,1.5,0,1520,1130,1905,4
4,2.75,2600,2.0,0,1960,640,1949,4
3,2.75,2520,1.0,0,1360,1160,1946,4
4,2.75,2410,1.0,0,1780,630,1956,4
3,2.0,2540,1.5,3,1600,940,1905,4
4,2.0,2210,1.0,1,1210,1000,1954,4
5,3.75,4130,2.0,0,3170,960,1985,4
4,3.5,3900,2.0,0,3900,0,2006,4
4,4.0,4460,2.0,0,4460,0,2001,4
6,2.5,3560,2.5,0,3560,0,1914,4
5,4.5,4270,2.0,0,3400,870,2007,4
2,1.5,980,2.0,0,980,0,1922,1
2,1.0,720,1.0,0,720,0,1955,1
3,1.0,1490,1.0,0,1490,0,1954,1
4,1.75,2000,1.0,0,1100,900,1965,1
3,2.5,1190,2.0,0,1190,0,2002,1
3,1.0,1390,1.0,0,1390,0,1960,1
3,1.75,950,1.0,0,790,160,1939,1
2,1.0,1270,1.0,0,650,620,1923,1
3,1.5,1260,1.0,0,1260,0,1955,1
3,1.75,1390,1.0,0,1390,0,1975,1
4,1.75,1730,1.0,0,1230,500,1977,1
4,1.5,2130,1.0,0,1100,1030,1962,1
4,2.5,2020,2.0,0,2020,0,2002,1
3,2.5,1940,1.0,0,1460,480,1989,1
4,2.5,1810,2.0,0,1810,0,1994,1
3,1.75,1890,1.0,0,1890,0,1966,1
3,2.5,1920,2.0,0,1920,0,1993,1
3,2.0,1240,1.0,0,1240,0,1967,1
2,1.25,860,2.0,0,860,0,2007,2
4,2.5,2320,2.0,0,2320,0,2004,2
4,2.5,2460,2.0,0,2460,0,1989,2
3,1.75,1590,1.0,0,1590,0,1988,2
4,1.75,2250,1.0,0,2150,100,1940,2
2,1.5,960,2.0,0,960,0,1993,2
6,2.25,3206,2.0,0,3206,0,2012,2
3,1.75,1890,1.0,0,1230,660,1944,2
3,2.5,1960,1.0,0,1290,670,1977,2
3,2.75,2090,2.0,0,2090,0,2012,2
2,1.0,1020,1.0,0,1020,0,1948,2
3,2.5,1540,3.0,0,1470,70,2008,2
3,1.75,1460,1.0,0,1460,0,1979,2
3,1.75,1310,1.0,0,1310,0,1976,2
2,1.5,1020,3.0,0,1020,0,2008,2
3,2.0,1510,1.0,0,1510,0,1954,2
5,2.25,2440,1.5,0,2440,0,1975,2
3,2.5,2310,2.0,0,2310,0,2011,2
3,1.75,1410,3.0,0,1410,0,2012,3
4,2.75,2280,1.5,0,1540,740,1930,3
3,1.75,1980,1.0,0,1980,0,1973,3
3,1.0,1670,1.0,0,1170,500,1967,3
4,2.5,2280,2.0,0,2280,0,2004,3
4,3.0,2920,1.0,3,1460,1460,1964,3
4,2.5,2550,2.0,0,2550,0,2005,3
4,1.75,1840,1.0,0,1220,620,1967,3
6,2.25,2820,1.5,2,1970,850,1940,3
2,2.0,1870,1.0,0,1870,0,2006,3
4,2.25,2250,2.0,0,2250,0,1980,3
2,3.0,3160,2.0,0,3160,0,1993,3
3,2.5,1750,2.0,0,1750,0,1991,3
2,1.0,1540,1.0,0,820,720,1946,3
4,1.75,2060,1.0,0,1160,900,1947,3
4,2.5,3290,2.0,0,3290,0,2002,4
3,2.5,1690,1.5,1,1690,0,1928,4
4,2.5,2660,2.0,2,2660,0,2003,4
4,1.75,2480,1.0,0,1390,1090,1950,4
5,3.0,3040,1.0,0,1970,1070,1968,4
3,2.5,2920,3.0,0,2920,0,2008,4
3,3.25,2640,2.0,0,1840,800,1912,4
5,2.5,3160,1.0,0,1780,1380,1971,4
4,1.0,3410,2.0,0,2190,1220,1910,4
4,3.25,3820,2.0,1,3310,510,1990,4
2,1.0,720,1.0,0,720,0,1950,1
3,1.0,1160,1.0,0,1160,0,1959,1
2,1.5,1020,2.0,0,1020,0,2004,1
4,1.0,1430,1.5,0,1430,0,1983,1
3,2.5,2000,2.0,0,2000,0,1992,1
3,1.0,1360,1.0,0,1360,0,1977,1
4,3.0,2163,2.0,0,2163,0,2006,1
3,1.75,1220,1.0,0,1220,0,1962,1
3,1.0,1030,1.0,0,880,150,1947,1
3,2.5,1850,2.0,0,1850,0,2003,1
2,1.0,960,1.0,0,960,0,1984,1
2,1.0,810,1.0,0,810,0,1928,1
3,2.0,1920,1.0,0,1510,410,1969,1
3,2.5,1420,1.0,0,1020,400,1963,1
3,2.0,1690,1.0,0,1690,0,1969,1
3,1.5,1500,1.0,0,1500,0,1953,1
4,2.0,2190,1.0,0,1180,1010,1977,1
3,1.75,1390,1.0,3,840,550,1912,1
4,2.5,2000,1.0,0,1200,800,1968,1
3,1.5,1060,1.0,0,1060,0,1973,2
4,2.25,2130,1.0,0,1380,750,1977,2
4,2.25,1930,1.0,0,1430,500,1984,2
5,1.75,2320,1.0,0,1160,1160,1956,2
4,2.25,2310,2.0,0,2310,0,1980,2
4,2.75,1970,1.0,0,1170,800,1977,2
3,2.25,998,2.0,0,798,200,2007,2
3,2.25,1352,3.0,0,1352,0,2007,2
4,2.5,1940,2.0,0,1940,0,2003,2
3,1.0,1620,1.5,0,1620,0,1911,2
3,2.25,1640,1.0,0,1640,0,1972,2
3,2.0,1340,3.0,0,1340,0,2008,2
3,3.25,1410,3.0,0,1410,0,2005,2
3,2.25,1445,2.0,0,1300,145,2003,2
4,2.5,2600,2.0,0,2600,0,1988,2
4,2.25,3060,2.0,0,3060,0,1992,2
4,2.0,1650,1.0,0,1000,650,1959,2
2,2.0,1150,1.0,0,860,290,1940,2
4,1.75,1750,1.5,0,1050,700,1926,2
2,1.0,1150,1.0,0,1150,0,1905,2
4,2.5,1930,1.0,0,1930,0,1968,2
3,2.0,1410,1.0,0,1410,0,1940,2
2,1.0,1840,1.5,0,1130,710,1910,2
3,1.75,1750,1.0,1,1300,450,1987,2
3,2.5,2100,2.0,2,2100,0,1999,3
3,2.0,1400,1.0,0,1400,0,1963,3
3,2.5,2030,2.0,0,2030,0,1991,3
5,3.0,3480,1.0,0,2340,1140,1976,3
3,1.75,1300,1.5,0,1300,0,1925,3
4,1.75,2000,1.5,0,1450,550,1926,3
4,2.5,2330,2.0,0,2330,0,1978,3
4,2.5,2840,2.0,0,2840,0,2012,3
4,2.25,2470,2.0,0,2470,0,1984,3
3,2.25,1660,1.0,0,1370,290,1980,3
4,2.5,2840,2.0,0,2840,0,1998,3
4,2.5,2660,2.0,0,2660,0,2001,3
4,3.25,2400,2.0,0,2400,0,1982,3
4,2.25,2430,1.0,0,2430,0,1993,3
4,2.5,2260,2.0,0,2260,0,1989,3
3,3.0,2480,1.0,0,1620,860,1976,3
4,2.75,3100,2.0,0,2000,1100,1919,4
4,2.75,2790,2.0,0,2790,0,1996,4
4,3.5,2730,2.0,0,2400,330,2006,4
4,2.5,2830,2.0,0,1980,850,1979,4
4,2.75,3780,2.0,0,3780,0,1999,4
4,3.5,3810,1.0,1,2560,1250,2013,4
3,2.5,3560,2.0,0,3560,0,1987,4
4,3.0,3750,2.0,0,3750,0,1976,4
4,2.25,4230,2.0,0,4230,0,1989,4
3,2.25,2950,1.5,0,2950,0,2006,4
4,4.25,5860,2.0,0,4910,950,1996,4
4,2.75,3720,1.0,4,1960,1760,1962,4
5,4.5,5190,2.0,2,3390,1800,1987,4
5,6.5,7270,2.0,0,6420,850,2010,4
4,1.0,1940,1.0,0,1080,860,1962,1
3,2.5,2130,2.0,0,2130,0,2003,2
3,2.5,1350,3.0,0,1270,80,2006,2
5,2.75,3060,1.0,0,1600,1460,1979,3
4,2.0,2520,1.0,0,1400,1120,1921,4
3,2.5,1370,2.0,0,1010,360,2007,2
4,2.5,2160,2.5,0,2160,0,1902,4
3,1.0,970,1.0,0,970,0,1959,1
3,1.5,1370,1.0,0,1370,0,1961,1
2,1.0,700,1.0,0,700,0,1953,1
3,1.0,1460,1.0,0,1460,0,1969,1
3,2.5,1040,2.0,0,720,320,2004,1
3,1.5,1350,1.0,0,1350,0,1941,1
3,1.0,990,1.0,0,990,0,1966,1
1,1.0,810,1.0,0,810,0,1941,1
3,1.0,1830,1.0,0,1830,0,1942,1
3,1.5,1770,1.0,0,1160,610,1959,1
2,1.0,1220,1.0,0,770,450,1910,1
2,1.0,1290,2.0,0,1290,0,2008,1
4,2.5,2380,2.0,0,2380,0,1997,1
2,1.75,1360,1.0,0,860,500,1975,1
5,2.25,2180,2.0,0,2180,0,1986,2
3,1.75,1440,1.0,0,960,480,1951,2
5,3.0,2100,1.0,0,1250,850,2013,2
3,2.5,1940,2.0,0,1940,0,2004,2
3,1.0,1080,1.0,0,1080,0,1955,2
3,1.5,1720,1.5,0,1720,0,1952,2
2,1.0,910,1.5,0,910,0,1906,2
4,2.0,1730,1.0,0,1010,720,1943,2
3,1.0,1280,1.0,0,1280,0,1968,2
2,2.5,980,2.0,0,670,310,2009,2
5,3.0,2480,1.0,0,1300,1180,2004,2
4,2.5,2160,2.0,0,2160,0,2010,2
3,2.25,2200,2.0,0,2200,0,1987,2
2,2.5,1480,3.0,0,1480,0,2009,2
3,2.5,2010,2.0,0,1390,620,2014,2
3,1.5,2020,1.0,0,1190,830,1956,2
2,2.5,1230,2.0,0,870,360,2004,2
2,2.25,1290,3.0,0,1290,0,2007,3
4,2.5,2780,1.0,0,1590,1190,1978,3
4,1.75,1940,1.0,0,1030,910,1922,3
4,2.25,1800,1.0,0,1360,440,1980,3
3,2.5,3720,2.0,0,3720,0,1982,3
4,1.75,2120,1.0,1,1190,930,1951,3
4,3.0,2110,1.5,2,1640,470,1930,3
2,1.75,2040,1.5,3,2040,0,1919,3
3,1.5,1620,1.0,0,1280,340,1954,3
4,2.0,1770,2.0,0,1770,0,1911,3
3,2.5,1570,3.0,0,1570,0,2010,3
4,2.5,2550,1.0,0,1290,1260,1964,3
4,2.5,3040,2.0,0,3040,0,1999,3
4,3.0,2400,1.0,0,1200,1200,1964,3
4,2.5,2670,2.0,0,2670,0,1989,3
4,2.5,2760,1.5,0,1680,1080,1928,4
3,2.5,2620,2.0,0,2620,0,1992,4
4,2.5,2980,2.0,0,2890,90,2000,4
4,2.5,3110,2.0,0,3110,0,2004,4
3,1.75,1720,1.0,0,1720,0,1954,4
4,3.25,3680,2.0,0,2840,840,2003,4
4,2.75,2600,1.5,0,1620,980,1936,4
4,1.75,2350,1.0,0,2350,0,1961,4
3,3.25,2170,1.5,0,1650,520,1928,4
4,2.5,2830,2.0,0,2830,0,1995,4
4,3.25,4700,2.0,0,3420,1280,1978,4
3,2.0,2700,1.0,0,1350,1350,1962,4
4,2.75,3300,2.0,0,3300,0,1953,4
4,2.25,3290,1.5,0,3290,0,1968,4
3,2.75,2980,1.5,2,2180,800,1917,4
5,3.0,4530,1.5,0,3200,1330,2003,4
3,2.5,2920,1.0,4,1800,1120,1954,4
4,3.25,3270,2.0,0,3110,160,2014,4
4,3.75,3280,2.0,0,2320,960,2008,4
4,4.5,5420,1.0,0,3890,1530,2001,4
4,2.25,3070,1.0,3,1870,1200,1976,4
4,3.75,3490,2.0,0,3490,0,2012,4
4,3.5,3460,2.0,0,2560,900,2004,4
5,1.75,3380,1.0,0,1690,1690,1963,4
2,1.0,790,1.0,0,790,0,1973,1
2,1.0,910,1.0,0,910,0,1943,1
4,1.5,1950,1.5,0,1950,0,1939,1
3,1.0,1660,1.0,0,1100,560,1963,1
3,1.5,1250,1.0,0,1250,0,1967,1
3,1.0,1040,1.0,0,1040,0,1947,1
2,0.75,650,1.0,0,650,0,1931,1
3,1.0,1900,1.5,0,1900,0,1942,1
5,1.75,2020,1.0,0,1220,800,1962,1
4,2.25,2510,1.0,0,1610,900,1972,1
3,1.0,1090,1.0,0,1090,0,1973,1
3,2.25,1490,1.0,0,1170,320,1987,1
3,2.5,1950,2.0,0,1950,0,1990,1
3,1.0,1090,1.0,0,1090,0,1981,1
3,1.0,1390,1.0,0,1390,0,1968,2
3,2.0,1350,1.0,0,1350,0,1989,2
3,2.5,1450,1.0,0,840,610,2007,2
3,1.75,1090,1.0,0,1090,0,1968,2
3,2.5,2010,2.0,0,2010,0,1977,2
3,1.75,1650,1.0,0,1060,590,1951,2
5,2.5,3001,2.0,0,3001,0,2006,2
3,1.0,1190,1.0,0,1190,0,1953,2
3,2.0,1480,1.0,2,740,740,1943,2
4,1.75,2180,1.0,0,1090,1090,1956,2
4,1.0,1410,1.0,0,810,600,1925,2
3,1.75,1960,1.0,0,980,980,1911,2
4,2.25,2140,2.0,0,2140,0,2002,2
3,2.0,1770,1.0,0,960,810,1954,2
3,2.25,2450,1.0,0,2450,0,1978,2
3,2.75,1250,2.0,0,1040,210,2010,2
4,2.5,3360,2.0,0,3360,0,2001,2
3,2.25,2350,1.0,0,1390,960,1977,2
5,2.5,3400,1.0,0,1700,1700,1959,2
4,2.5,3740,1.0,0,2260,1480,2004,2
5,4.75,3830,1.0,0,2130,1700,1976,2
4,2.5,2040,2.0,0,2040,0,2012,3
4,2.5,2790,2.0,0,2790,0,2009,3
3,3.5,2876,2.0,0,2360,516,2007,3
5,3.0,2450,2.0,0,2450,0,1994,3
3,2.5,1580,2.0,0,1010,570,2008,3
3,1.75,1690,1.0,0,1690,0,1958,3
2,2.0,1680,1.0,0,1680,0,2006,3
7,4.0,3440,2.0,0,3440,0,1970,3
4,2.0,2250,1.0,0,1200,1050,1956,3
3,2.5,1490,3.0,0,1490,0,2004,3
3,1.0,1440,2.0,0,1440,0,1910,3
3,2.0,1530,1.0,0,1530,0,1937,3
3,1.75,1580,1.0,0,1180,400,1951,3
5,2.0,2290,1.0,0,1190,1100,1964,3
4,1.75,2090,1.0,0,1070,1020,1963,3
4,2.25,2710,2.0,0,2710,0,1977,3
3,1.75,1680,1.0,0,870,810,1922,3
3,1.0,1710,1.5,0,1710,0,1909,3
3,3.5,1810,2.0,0,1440,370,2009,3
4,2.0,2260,1.0,0,1430,830,1958,3
4,1.75,1950,1.0,0,1370,580,1969,3
3,2.5,1740,2.0,0,1740,0,1975,3
4,2.5,2210,2.0,0,2210,0,2013,3
4,2.5,2740,2.0,0,2740,0,1993,3
4,3.5,3400,2.0,0,3400,0,2012,3
3,2.0,1940,1.5,0,1150,790,1944,3
5,3.0,3410,1.0,0,1870,1540,1968,3
4,2.5,3000,2.0,0,3000,0,2006,3
3,2.5,2030,2.0,0,2030,0,1975,4
3,3.25,3190,2.0,0,3190,0,2007,4
3,3.25,3610,2.0,0,2440,1170,2003,4
3,1.75,2340,1.0,0,2340,0,1967,4
6,3.0,2890,2.5,0,2290,600,1906,4
5,2.75,3150,2.0,0,3150,0,2013,4
4,2.5,3560,1.0,2,2290,1270,1986,4
4,2.5,3520,2.5,0,2650,870,2006,4
4,2.5,3490,2.0,3,3490,0,2000,4
4,3.25,4400,2.0,0,4400,0,2003,4
5,4.25,3530,2.0,0,3530,0,2001,4
5,3.25,4860,2.0,2,3820,1040,1989,4
3,1.0,1100,1.0,0,1100,0,1978,1
2,1.0,700,1.0,0,700,0,1952,1
3,1.0,860,1.0,0,860,0,1963,1
2,1.0,1170,1.0,2,1170,0,1911,1
2,1.0,1240,1.0,0,1240,0,1967,1
3,1.75,1340,1.0,0,1340,0,1973,1
4,2.0,1630,1.0,0,1050,580,1975,1
4,2.5,2230,2.0,0,2230,0,2006,1
3,2.0,1850,1.0,0,1150,700,1952,1
3,2.0,1570,1.0,0,1570,0,1998,1
3,2.5,1780,1.0,0,1400,380,1986,1
2,1.0,700,1.0,0,700,0,1949,1
3,1.0,1260,1.0,0,1260,0,1946,2
3,1.75,2110,2.0,0,2110,0,1966,2
3,1.5,1220,3.0,0,1220,0,2007,2
3,1.0,1480,1.0,0,1480,0,1952,2
3,1.0,1050,1.0,0,1050,0,1953,2
4,2.5,2010,2.0,0,2010,0,1995,2
3,2.5,1840,2.0,0,1840,0,2012,2
3,2.5,2220,2.0,0,2220,0,1990,2
5,2.0,1700,1.0,0,1000,700,1956,2
3,1.0,1050,1.5,0,1050,0,1906,2
3,2.25,1970,2.0,0,1970,0,1997,2
3,2.25,2120,2.0,0,2120,0,1984,2
5,3.0,2257,1.0,0,1363,894,2005,2
3,3.5,2100,2.0,0,2100,0,1980,2
4,1.75,2010,1.0,0,1340,670,1957,2
3,1.0,1290,1.0,0,980,310,1951,2
3,2.5,1690,2.0,0,1150,540,2014,2
4,1.75,1620,1.0,0,860,760,1947,2
4,2.5,3040,2.0,0,3040,0,1999,2
3,2.75,2580,2.0,0,2580,0,2008,2
3,2.5,2910,2.0,0,2910,0,1989,2
3,1.0,1660,1.0,0,1060,600,1940,2
4,2.5,2310,2.0,0,2310,0,1991,2
4,2.5,2150,1.0,0,1420,730,1978,2
3,2.75,1850,1.5,0,1850,0,1965,2
4,2.75,2270,1.0,0,1290,980,1973,2
3,2.0,2090,1.5,0,2090,0,1959,2
3,1.75,2170,1.0,0,1450,720,1986,3
3,2.5,1820,2.0,0,1820,0,2005,3
3,1.75,1600,1.5,0,1600,0,1924,3
4,2.75,2450,1.0,0,2450,0,1974,3
4,1.75,1900,1.0,0,950,950,1955,3
2,2.0,2370,1.5,0,1600,770,1992,3
3,2.5,2090,1.0,0,1360,730,1962,3
3,1.75,2000,1.0,0,1110,890,1921,3
3,1.5,1830,1.0,0,1830,0,1957,3
4,2.5,2240,2.0,0,2240,0,1989,3
5,1.75,2220,1.5,0,1420,800,1923,3
5,2.5,2540,2.0,0,1760,780,1929,3
4,2.75,1680,1.0,0,1680,0,1966,3
4,2.5,2470,2.0,0,2470,0,1993,3
3,1.75,1830,1.5,2,1830,0,1903,3
3,1.5,2360,2.0,0,1930,430,1926,4
4,3.25,3200,2.0,0,3200,0,2004,4
4,2.25,2060,1.0,0,1360,700,1941,4
4,2.5,2700,2.0,0,2700,0,2004,4
5,5.0,5774,1.0,2,4490,1284,1984,4
4,2.5,3430,2.0,0,3430,0,2000,4
3,2.5,3030,1.5,0,3030,0,1992,4
3,2.75,2470,2.0,0,2470,0,2007,4
3,2.5,2580,2.0,0,2580,0,1986,4
4,2.5,2190,2.5,0,2190,0,1958,4
3,2.5,3100,1.0,0,3100,0,1954,4
4,2.5,3320,2.0,0,3320,0,1995,4
5,2.25,2510,2.0,0,2510,0,1972,4
5,4.5,3810,2.0,0,3810,0,2008,4
4,2.25,4470,2.0,0,4470,0,1988,4
4,3.5,4910,1.5,0,3110,1800,2007,4
3,1.0,1040,1.0,0,1040,0,1959,1
3,1.0,1060,1.0,0,1060,0,1970,1
3,1.0,1150,1.0,0,1150,0,1932,1
3,1.0,1090,1.0,0,1090,0,1967,1
3,1.0,980,1.5,0,980,0,1903,1
4,2.0,1670,1.0,0,1670,0,1967,1
3,1.0,1160,1.0,0,1160,0,1969,1
3,2.0,1400,1.0,0,1150,250,1979,1
3,2.0,1400,1.0,0,700,700,1948,1
3,1.75,1490,1.0,0,1490,0,1990,1
3,1.0,1230,1.0,0,1230,0,1957,1
3,2.0,1650,1.0,0,1160,490,1979,1
4,2.5,2070,2.0,0,2070,0,1989,1
3,2.5,1690,2.0,0,1690,0,2003,1
3,2.25,1590,2.0,0,1590,0,1991,1
3,1.0,1010,1.0,0,1010,0,1969,1
4,2.5,1840,2.0,0,1400,440,2004,1
3,1.0,1330,1.5,0,1330,0,1959,1
3,1.5,850,1.0,0,850,0,1986,1
3,1.0,1220,1.0,0,1220,0,1955,2
3,2.0,1510,1.0,2,1230,280,1973,2
4,1.75,2020,1.0,0,1010,1010,1963,2
3,2.25,1490,2.0,0,1220,270,2009,2
2,1.0,880,1.0,0,880,0,1919,2
4,2.5,2150,2.0,0,2150,0,1991,2
3,1.75,1960,1.0,0,980,980,1948,2
3,2.25,1180,2.0,0,1180,0,1986,2
4,1.75,2290,1.0,0,1340,950,1960,2
3,2.5,1232,3.0,0,1232,0,2007,2
3,2.5,1700,2.0,0,1700,0,1994,2
3,1.0,1400,1.0,0,1400,0,1957,2
4,2.5,2710,2.0,0,2710,0,1998,2
4,1.75,1890,1.0,0,1250,640,1960,2
3,2.5,1720,2.0,0,1720,0,2010,2
3,2.5,2240,2.0,0,2240,0,1996,2
3,1.5,1120,1.0,0,1120,0,1955,2
3,1.0,1630,1.0,0,1630,0,1953,2
3,1.5,1490,1.0,0,1490,0,1963,2
3,1.5,1340,1.0,0,1340,0,1956,2
4,1.75,1880,1.0,0,1010,870,1976,2
2,1.0,1320,1.0,1,1320,0,1912,2
3,2.5,1870,1.0,0,1470,400,1980,2
3,1.75,1410,1.0,0,1410,0,1924,2
3,1.5,1260,1.0,0,1260,0,1959,2
3,1.0,1660,1.0,0,1000,660,1946,2
7,3.5,2870,1.0,0,1520,1350,1961,2
4,2.0,2050,1.5,0,1210,840,1941,2
4,2.5,2240,2.0,0,2240,0,1995,2
3,2.5,1840,2.0,0,1840,0,1997,3
3,2.5,2700,2.0,0,2700,0,1991,3
3,2.0,1640,1.0,0,1640,0,1977,3
3,2.25,1980,1.0,0,1980,0,1980,3
4,2.5,3020,1.0,0,1600,1420,1979,3
2,1.0,1490,1.0,0,1090,400,1946,3
3,2.5,2360,2.0,3,2360,0,1996,3
4,2.75,2550,1.0,0,1440,1110,1986,3
5,1.75,2000,2.0,0,2000,0,1921,3
4,2.5,2240,1.0,0,2240,0,1983,3
4,2.0,1550,1.5,0,1550,0,1909,3
4,2.5,2680,2.0,0,2680,0,1989,3
4,2.0,2560,1.0,0,1890,670,1947,3
4,3.25,2740,2.0,0,2060,680,2003,3
3,2.5,4560,2.0,0,3800,760,1986,3
4,3.0,3150,2.0,0,3150,0,2001,3
4,2.5,3240,2.0,0,3240,0,1985,4
5,3.75,3580,2.0,0,3190,390,1999,4
4,2.5,3310,2.0,0,3310,0,2004,4
5,2.75,3030,2.0,0,3030,0,2013,4
4,3.5,3930,2.0,1,2820,1110,2013,4
4,1.75,2930,1.0,3,1670,1260,1947,4
4,2.5,3950,3.0,0,3950,0,2013,4
5,4.25,3920,2.0,0,2900,1020,1990,4
4,3.25,3740,1.0,0,2000,1740,1988,4
4,2.5,3200,2.0,0,3200,0,2006,4
2,1.0,1010,1.0,0,1010,0,1955,1
3,1.0,1000,1.0,0,1000,0,1940,1
5,1.75,1730,1.0,0,1050,680,1978,1
3,2.0,1020,2.0,0,720,300,2004,1
4,2.25,1860,1.0,0,1120,740,1979,1
5,1.0,1460,2.0,0,1460,0,1941,1
2,1.0,870,1.0,0,870,0,1941,1
4,3.5,1850,2.0,0,1130,720,1986,1
3,2.25,1440,1.0,0,940,500,1982,1
3,2.0,1900,1.0,0,950,950,1966,1
2,1.5,1070,1.0,0,1070,0,1985,1
4,2.0,1510,1.0,0,1510,0,1955,1
3,2.5,1480,2.0,0,1480,0,1987,1
2,1.0,830,1.0,0,830,0,1954,1
3,2.5,1870,2.0,0,1870,0,2005,2
3,2.25,2060,1.0,0,1560,500,1978,2
4,2.5,2340,2.0,0,2340,0,2003,2
3,2.0,1760,1.0,0,1060,700,1977,2
3,1.0,1250,1.0,0,1250,0,1951,2
3,1.5,1170,1.0,0,1170,0,1960,2
3,2.5,1480,2.0,0,1180,300,2012,2
3,1.0,1260,1.0,0,720,540,1944,2
4,1.0,1980,1.5,0,1980,0,1962,2
4,2.5,2440,2.0,0,2440,0,2009,2
4,1.5,1370,1.0,0,900,470,1972,2
4,2.5,2790,2.0,0,2790,0,2005,2
3,1.5,1100,2.0,0,940,160,2007,2
3,2.25,1410,2.0,0,1290,120,2005,2
3,3.25,1860,3.0,0,1860,0,2007,2
3,1.75,1180,1.0,0,940,240,1981,2
3,2.5,2740,2.0,4,2740,0,1973,2
3,2.5,1800,2.0,0,1800,0,1990,2
3,2.5,2670,1.0,0,2670,0,1988,2
4,2.5,2280,2.0,0,2280,0,2001,2
3,2.5,2320,2.0,2,2320,0,1992,2
3,1.75,2150,1.0,0,1200,950,1956,2
3,3.0,1970,1.0,0,1970,0,2010,2
3,2.25,1990,2.0,0,1990,0,1984,2
4,2.25,2270,1.0,0,1290,980,1977,2
3,1.75,1560,1.5,2,1000,560,1926,2
4,2.5,2430,2.0,0,2430,0,2009,2
3,2.0,1450,1.5,0,1450,0,1900,2
3,2.5,2370,2.0,0,2370,0,2003,3
3,1.5,1260,1.5,0,1260,0,1931,3
1,1.0,1140,1.5,0,1140,0,1920,3
2,2.0,2260,1.0,0,2260,0,1990,3
3,2.25,1520,3.0,0,1520,0,2013,3
4,2.5,2110,2.0,0,2110,0,2000,3
3,2.5,2134,2.5,0,2134,0,2008,3
3,2.5,2720,2.0,0,2720,0,2005,3
3,2.5,2170,2.0,0,2170,0,2003,3
3,2.25,1720,1.5,0,1450,270,1921,3
4,2.5,3160,2.0,0,3160,0,1983,3
5,2.5,3200,2.0,0,3200,0,2009,3
2,1.0,2020,1.0,3,1700,320,1947,4
3,2.0,2050,1.0,0,1180,870,1926,4
5,2.75,2830,2.0,0,2830,0,2006,4
4,2.5,3120,2.0,0,3120,0,2003,4
3,2.0,2180,1.0,0,1100,1080,1904,4
4,3.25,3120,2.0,0,2370,750,2005,4
5,1.5,3360,2.0,0,3360,0,2014,4
4,2.75,3280,2.0,0,3280,0,1996,4
3,2.0,2220,1.0,2,1220,1000,1947,4
4,3.0,5520,2.0,3,3570,1950,2008,4
5,4.25,6490,2.0,3,3940,2550,1991,4
3,2.0,1700,1.0,0,890,810,1944,2
5,2.5,1970,2.0,0,1970,0,1994,1
3,2.25,1410,1.0,2,1170,240,1987,2
3,2.5,2480,2.0,0,2480,0,1986,2
2,2.0,1360,1.0,0,780,580,1944,2
3,2.5,2130,1.0,0,1210,920,1994,3
4,2.5,2060,1.0,0,1440,620,1985,3
3,2.0,1940,1.0,0,1940,0,1954,4
2,1.0,680,1.0,0,680,0,1941,1
3,1.0,950,1.0,0,950,0,1954,1
2,1.0,930,1.0,0,930,0,1942,1
2,1.0,910,1.0,0,910,0,1981,1
3,1.5,2200,1.5,0,2200,0,1932,1
3,1.0,1080,1.0,0,1080,0,1942,1
2,2.25,1610,2.0,0,1610,0,1979,1
3,1.0,970,1.0,0,970,0,1970,1
2,2.0,1470,2.0,0,1470,0,2005,1
3,2.25,1580,2.0,0,1580,0,1986,1
4,1.5,1310,1.0,0,1060,250,1953,1
2,1.0,1120,1.0,0,1120,0,1980,1
4,1.75,2420,1.0,0,1480,940,1979,1
3,2.5,1720,2.0,0,1720,0,2005,1
3,2.5,1270,2.0,0,1270,0,1993,1
4,1.75,2080,1.0,0,1040,1040,1955,1
1,1.5,810,2.0,0,810,0,1982,1
5,1.5,2120,1.5,0,2120,0,1962,1
4,2.5,1700,2.0,0,1700,0,1988,1
3,2.75,2170,1.0,0,1380,790,1978,1
5,3.0,2100,1.0,0,1200,900,2007,1
3,1.75,1610,1.0,0,1610,0,1981,2
3,1.0,1370,1.0,0,1370,0,1960,2
4,1.75,2310,1.0,0,1650,660,1976,2
3,2.5,2680,2.0,0,2680,0,1990,2
4,2.0,1580,2.0,0,1580,0,1906,2
4,2.5,1830,2.0,0,1830,0,2003,2
3,2.25,1640,2.0,0,1640,0,1985,2
4,2.75,2070,1.0,0,1120,950,1945,2
2,1.5,1660,1.0,0,830,830,1908,2
3,2.5,1670,2.0,0,1670,0,1999,2
3,2.5,1690,2.0,0,1150,540,2014,2
4,2.5,2490,2.0,0,2490,0,1999,2
4,2.75,2500,2.0,0,2500,0,1966,2
3,2.5,1920,2.0,0,1920,0,1995,2
3,2.5,2200,2.0,0,2200,0,2009,2
2,1.5,1010,1.5,0,1010,0,1906,2
3,1.75,1800,1.0,0,1800,0,1967,2
5,2.75,2190,1.0,0,1370,820,1978,2
3,1.5,1710,1.5,0,1410,300,1928,2
5,1.75,1250,1.0,0,1250,0,1966,2
3,1.75,1630,1.0,0,1630,0,1967,2
4,2.5,3060,1.0,0,1700,1360,1968,2
2,1.0,1490,1.0,0,860,630,1929,2
3,2.5,1350,3.0,0,1350,0,2005,2
3,2.25,1450,2.0,0,980,470,2005,2
3,1.75,2200,2.0,2,2200,0,1908,2
3,1.0,1500,1.5,0,1370,130,1926,2
2,2.25,1260,3.0,0,1260,0,2004,2
4,2.0,1690,1.5,0,1550,140,1901,2
3,2.5,1680,2.0,0,1380,300,2008,3
3,1.75,1890,1.0,0,1290,600,1974,3
3,3.5,2320,2.0,0,2060,260,1997,3
4,1.0,1660,1.5,0,1260,400,1945,3
4,2.25,2110,2.0,0,2110,0,1979,3
3,2.25,2030,1.0,0,1500,530,1984,3
4,2.5,2500,2.0,0,2500,0,2013,3
3,2.25,2030,1.0,0,1190,840,1977,3
5,1.75,3290,1.5,0,3290,0,1973,3
4,2.5,2460,2.0,0,2460,0,1998,3
4,2.5,3430,2.0,0,3430,0,2013,3
3,2.0,1610,1.5,0,1610,0,1940,3
4,3.25,5010,2.0,0,5010,0,1988,3
3,1.75,2010,1.0,0,1230,780,1912,4
4,2.5,2660,2.0,0,2660,0,1993,4
5,2.0,3370,1.5,0,2140,1230,1907,4
4,2.5,3480,2.0,0,3480,0,1988,4
2,2.5,2380,1.0,2,2380,0,2011,4
4,3.5,2640,2.0,2,2640,0,1937,4
5,3.25,4180,2.0,0,2880,1300,1979,4
4,2.75,2730,1.5,0,1550,1180,1921,4
2,1.75,2430,1.0,4,2430,0,1951,4
4,2.5,3190,1.0,3,1680,1510,1967,4
4,3.5,3410,2.0,0,3410,0,2008,4
3,1.75,1140,1.0,0,1140,0,1969,1
2,1.0,950,1.0,0,950,0,1926,1
1,1.0,820,1.0,0,760,60,2007,1
3,1.0,1050,1.0,0,1050,0,1967,1
4,2.0,1700,1.0,0,1700,0,1978,1
3,1.5,1650,1.0,0,1090,560,1967,1
2,1.0,1770,1.5,0,960,810,1943,1
4,1.5,2500,1.0,0,1500,1000,1961,1
4,2.0,1960,1.0,0,1160,800,1978,1
3,1.0,1320,1.0,0,1320,0,1957,1
4,2.5,1990,2.0,0,1990,0,1989,1
3,1.75,1570,2.0,0,1570,0,1982,1
2,1.0,790,1.0,0,790,0,1953,1
4,2.5,1860,1.0,0,1220,640,1983,1
2,1.0,870,1.5,0,870,0,1906,1
3,2.5,2090,2.0,0,2090,0,2002,1
3,1.75,1560,1.0,0,1560,0,1964,1
3,1.0,910,1.0,0,740,170,1950,1
6,5.25,2860,2.0,0,2860,0,1978,2
3,1.0,2120,1.0,0,1060,1060,1967,2
3,1.0,1090,1.0,0,1090,0,1955,2
2,2.5,1590,2.0,0,1220,370,2009,2
3,1.0,1092,1.5,0,1092,0,1918,2
3,2.25,1400,1.0,0,1140,260,1987,2
2,1.0,790,1.0,0,790,0,1955,2
3,1.75,1280,1.0,0,1280,0,1969,2
3,1.75,1480,1.0,0,1480,0,1965,2
4,2.25,1870,1.0,0,1170,700,1959,2
6,3.0,1880,1.0,0,1880,0,1966,2
4,2.5,1600,1.0,0,830,770,1947,2
3,2.5,2170,2.0,0,2170,0,2004,2
4,2.5,2303,2.0,0,2303,0,2013,2
3,1.0,1180,1.0,0,1180,0,1959,2
2,1.0,860,1.0,0,860,0,1948,2
3,1.0,1060,1.0,0,1060,0,1967,2
3,1.5,1240,1.0,0,1240,0,1954,2
5,3.5,2800,2.5,0,2800,0,1903,2
4,2.25,2220,2.0,0,2220,0,1999,2
4,1.75,1590,2.0,0,1590,0,1922,2
2,1.0,1150,1.0,0,1150,0,1947,2
4,3.0,2800,2.0,0,2800,0,2002,2
3,1.75,1690,2.0,0,1380,310,2008,2
3,2.5,1700,2.0,0,1700,0,2003,2
3,1.5,1490,1.0,0,1490,0,1959,2
2,2.25,1230,2.0,0,960,270,2012,2
4,1.0,1320,1.5,0,1320,0,1929,2
4,2.25,1770,1.0,0,1190,580,1965,2
3,1.5,1080,1.5,0,1080,0,1920,2
2,1.0,1730,2.0,0,1730,0,1945,2
5,2.5,2430,2.0,0,2430,0,2001,2
3,2.5,1800,2.0,0,1800,0,2014,2
3,2.25,1970,2.0,0,1680,290,2008,2
4,1.75,1940,1.0,0,970,970,1941,2
4,2.5,2800,2.0,0,2800,0,2004,2
3,1.75,1200,1.0,0,1200,0,1906,2
3,2.0,2010,2.0,0,1510,500,2003,2
3,1.5,1270,3.0,0,1270,0,2007,2
2,1.75,1300,2.0,0,1300,0,1948,2
3,1.5,2060,1.0,0,2060,0,1953,2
4,1.0,1210,1.5,0,1210,0,1900,2
1,2.25,2140,1.0,0,1470,670,1976,2
3,2.25,1270,2.0,0,1040,230,2005,2
4,1.75,1650,1.0,0,1150,500,1950,2
4,2.75,2050,1.0,0,1180,870,1986,2
2,1.75,1480,1.0,0,840,640,1951,2
5,3.5,4460,3.0,2,3280,1180,2013,2
3,1.0,1910,1.0,0,1010,900,1946,2
4,1.75,2090,1.5,0,1250,840,1925,2
5,3.5,3200,2.0,0,3200,0,1989,2
3,2.0,2020,1.0,0,1020,1000,1963,3
4,2.5,2670,2.0,0,2670,0,2006,3
4,2.0,1820,1.0,0,1820,0,1967,3
4,3.5,2680,2.0,0,2040,640,1942,3
3,1.5,1540,2.0,0,1540,0,1941,3
3,2.5,2830,2.0,0,2830,0,2001,3
5,2.25,2890,2.0,0,2890,0,1977,3
3,2.5,2660,2.0,0,2660,0,2014,3
4,2.75,2820,1.0,0,1860,960,1965,3
3,2.5,1700,2.0,0,1700,0,1992,3
3,2.5,2480,2.0,0,2480,0,2004,3
4,2.5,3550,2.0,0,3550,0,2007,3
4,2.5,2150,2.0,0,2150,0,1982,3
4,3.0,2690,1.0,0,2690,0,1954,3
3,2.25,1990,2.0,0,1990,0,1987,3
4,2.5,2650,2.0,0,2650,0,2006,3
4,2.5,3230,2.0,0,3230,0,2004,4
3,2.5,2770,2.0,2,2770,0,1992,4
6,2.0,2150,1.0,0,1270,880,1952,4
4,1.75,2450,1.0,2,1630,820,1987,4
4,2.25,2560,1.0,0,1760,800,1976,4
4,3.5,3070,2.0,0,2190,880,2009,4
4,2.75,3160,2.0,0,3160,0,2014,4
4,2.25,3500,1.0,4,1830,1670,1938,4
4,2.25,2260,1.0,0,2260,0,1967,4
4,3.5,3120,2.0,0,2480,640,2008,4
4,2.75,2620,1.5,2,1720,900,1926,4
3,2.0,2390,2.0,1,2390,0,1939,4
6,3.0,2880,2.0,0,2180,700,1919,4
4,3.5,4560,1.0,3,2230,2330,1995,4
4,3.5,4380,1.0,0,4380,0,2001,4
4,3.5,4460,1.0,0,2550,1910,1962,4
3,1.0,1010,1.0,0,1010,0,1966,1
2,1.75,1100,1.0,0,1100,0,1980,1
3,1.75,1380,1.0,0,990,390,1981,1
2,1.0,1080,1.0,0,1080,0,1972,1
3,1.0,1240,1.0,0,1240,0,1916,1
3,1.0,1020,1.0,0,1020,0,1956,1
4,2.5,2160,2.0,0,2160,0,1993,1
3,1.0,1060,1.0,2,1060,0,1956,1
5,2.0,1930,1.5,0,1930,0,1941,1
2,1.75,1330,1.0,0,1330,0,1993,1
3,1.5,1780,1.0,0,1780,0,1953,1
2,1.0,1140,1.0,0,1140,0,1947,1
3,2.0,1170,1.0,0,1170,0,1984,1
3,1.5,1060,1.0,0,1060,0,1973,1
3,2.5,1990,1.0,0,1570,420,1969,1
6,2.0,2220,1.0,0,2220,0,1977,1
4,1.0,1310,1.5,0,1160,150,1945,1
3,1.75,1390,1.0,0,860,530,1957,1
3,2.5,2030,2.0,0,2030,0,1993,1
3,1.75,2380,1.5,0,1320,1060,1935,1
3,2.25,1870,2.0,0,1870,0,1997,1
2,1.0,790,1.0,0,790,0,1925,1
3,2.5,2720,2.0,0,2720,0,2002,1
2,1.0,970,1.0,0,970,0,1949,2
4,2.25,2000,1.0,0,2000,0,1978,2
3,1.0,990,1.0,0,990,0,1947,2
3,1.0,1250,1.0,0,1250,0,1969,2
3,2.25,1800,2.0,0,1800,0,1995,2
4,2.5,2220,2.0,0,2220,0,2014,2
4,2.75,1800,1.0,0,1050,750,2002,2
3,1.5,980,1.0,0,980,0,1969,2
3,2.5,1530,3.0,0,1530,0,2009,2
3,2.5,2150,2.0,0,2150,0,1988,2
3,1.75,2000,1.0,0,2000,0,1961,2
3,2.0,1540,1.0,0,1120,420,1961,2
3,2.25,1445,2.0,0,1300,145,2003,2
3,1.75,1540,1.0,0,1540,0,1967,2
3,1.75,2470,1.0,1,1570,900,1962,2
3,2.0,1440,1.0,0,1440,0,2007,2
1,1.0,960,1.0,0,960,0,1945,2
3,2.75,2550,2.0,0,2550,0,1994,2
3,1.0,1150,1.0,0,1150,0,1906,2
4,2.25,2080,1.0,0,1220,860,1979,2
2,1.0,1200,1.0,0,1070,130,1940,2
4,2.0,1660,1.0,0,850,810,1945,2
4,2.0,1790,1.0,2,840,950,1909,2
3,3.5,2380,2.0,3,1670,710,1997,2
3,2.5,1900,2.0,0,1900,0,1990,3
4,2.5,3290,2.0,0,3290,0,1992,3
3,2.75,2100,2.0,0,1510,590,1998,3
3,1.0,1450,1.0,1,950,500,1948,3
4,2.5,1900,2.0,0,1900,0,1994,3
3,1.75,1300,1.0,0,1300,0,1983,3
3,2.25,2020,2.0,0,2020,0,1998,3
3,3.0,1960,2.0,0,1600,360,2007,3
3,2.5,2540,2.0,0,2540,0,1999,3
4,2.5,2910,2.0,2,2910,0,1998,3
3,2.25,2230,2.0,0,2230,0,1987,3
4,2.5,2360,2.0,0,2360,0,2001,3
4,2.75,2450,2.0,0,2450,0,1988,3
4,2.5,2630,2.0,0,2630,0,1986,3
4,2.25,2750,1.0,0,1500,1250,1948,3
4,3.5,2350,2.0,3,1670,680,1994,3
4,2.5,2340,1.0,2,1590,750,1964,3
4,2.75,2550,1.0,0,1700,850,1972,3
4,2.5,3010,2.0,0,3010,0,1996,3
4,3.25,2780,2.0,0,2780,0,2006,4
3,2.5,2020,3.0,3,2020,0,2000,4
4,2.75,2830,2.0,0,2830,0,1998,4
4,2.75,3488,2.0,0,3488,0,1998,4
5,3.0,2876,1.0,2,1970,906,1973,4
5,3.75,5330,2.0,2,3570,1760,2006,4
4,3.25,2790,1.0,3,1130,1660,1963,4
5,4.0,4850,2.0,0,4850,0,1977,4
4,2.75,2290,2.0,0,2170,120,1926,4
3,4.0,3880,2.0,3,3700,180,2009,4
4,3.25,3810,1.0,1,2680,1130,2007,4
3,2.25,2760,2.0,0,2760,0,1978,4
3,2.5,4460,2.0,0,4460,0,1992,4
2,1.0,820,1.0,0,820,0,1954,1
2,2.5,1160,2.0,0,1160,0,1998,1
4,1.5,1740,1.0,0,1020,720,1962,1
2,1.0,1400,1.0,0,900,500,1922,1
3,1.0,870,1.0,0,870,0,1969,1
3,1.0,910,1.0,0,910,0,1956,1
2,1.0,740,1.0,0,740,0,1938,1
4,2.25,1720,1.0,0,1720,0,1973,1
4,2.0,1580,1.0,0,1040,540,1967,1
2,1.0,940,1.0,0,940,0,1959,1
4,2.75,2570,2.0,0,1720,850,1998,1
3,2.5,1550,2.0,0,1550,0,2011,1
2,1.5,840,2.0,0,840,0,2005,1
1,0.75,1170,1.0,0,880,290,1962,1
4,2.0,980,1.0,0,980,0,1978,1
5,2.5,2760,2.0,0,2760,0,2006,2
6,2.0,2040,1.0,0,2040,0,1943,2
4,1.75,2200,1.5,0,1400,800,1942,2
3,1.5,2320,1.0,0,2320,0,1976,2
2,1.0,1070,1.0,2,1070,0,1949,2
3,2.0,1110,1.0,0,1110,0,1978,2
3,2.25,998,2.0,0,798,200,2007,2
3,2.25,1347,3.0,0,1347,0,2010,2
3,2.5,1750,2.0,0,1750,0,1994,2
4,3.5,3150,2.0,0,3150,0,2005,2
3,1.0,1070,1.0,0,1070,0,1951,2
4,2.5,1980,2.0,0,1980,0,1988,2
3,1.0,1220,1.0,0,1220,0,1966,2
4,2.5,2052,2.0,0,2052,0,2014,2
2,1.0,1060,2.0,0,1060,0,1979,2
3,2.25,1280,3.0,0,1280,0,2005,2
2,1.75,1060,1.0,0,1060,0,1977,2
3,1.5,1360,3.0,0,1360,0,2008,2
3,1.0,1100,1.5,4,1100,0,1922,2
5,3.5,2420,2.0,0,2420,0,2013,2
2,2.5,1230,2.0,0,1060,170,2011,2
3,1.0,1250,1.0,0,1250,0,1956,2
4,2.5,3140,2.0,0,3140,0,1991,2
3,1.0,1040,1.0,0,1040,0,1942,2
3,2.25,1950,1.0,0,1950,0,2006,2
4,3.0,3220,2.0,0,2450,770,1990,2
2,2.5,1520,2.0,0,1240,280,2007,2
3,3.5,1900,2.0,0,1430,470,2008,2
3,2.75,2200,1.0,0,1100,1100,1982,2
3,2.25,1470,2.0,0,1090,380,2007,2
3,2.25,1820,1.0,0,1240,580,1981,2
4,2.25,3250,2.0,0,3250,0,1983,2
5,2.25,2230,1.0,0,1320,910,1978,2
4,2.0,1640,2.0,0,1640,0,1907,2
2,1.75,1560,1.0,0,780,780,1904,2
2,1.75,2860,1.0,4,1510,1350,1948,3
4,2.25,2350,1.0,0,1430,920,1977,3
4,1.75,3000,1.0,3,1500,1500,1950,3
4,3.0,2170,1.0,0,1370,800,1968,3
3,1.75,1650,1.0,0,1040,610,1908,3
4,2.75,2750,1.0,3,1720,1030,1981,3
4,2.5,2980,2.0,0,2980,0,2000,3
3,1.75,2060,1.0,0,1350,710,1984,3
4,2.5,3240,1.0,0,1860,1380,1977,3
4,1.75,2260,1.0,1,1130,1130,1947,3
4,2.5,2860,2.0,0,2860,0,1999,3
4,1.75,2740,1.0,2,1370,1370,1954,3
3,2.5,2670,2.0,0,2670,0,1989,3
3,2.5,2450,2.0,0,2450,0,2010,3
4,2.5,2600,2.0,0,2600,0,1996,3
3,2.0,2000,1.0,0,1100,900,1916,3
4,2.5,2930,2.0,0,2930,0,1998,4
4,2.5,2350,2.0,0,2350,0,1987,4
4,2.75,2410,1.0,0,1410,1000,1950,4
4,3.25,3090,2.0,4,3090,0,2013,4
4,3.25,3340,1.5,0,2240,1100,1963,4
4,3.0,4260,2.0,0,4260,0,1996,4
4,3.25,3440,2.0,0,3440,0,1983,4
4,2.5,3030,1.5,0,3030,0,1988,4
4,3.75,3860,2.5,0,3860,0,2007,4
4,3.0,3600,1.0,4,2100,1500,1976,4
3,2.75,2890,2.0,3,2830,60,1987,4
1,0.75,430,1.0,0,430,0,1912,1
2,1.0,580,1.0,0,580,0,1943,1
3,1.0,1080,1.0,0,1080,0,1967,1
2,1.0,1300,1.0,0,1300,0,1958,1
4,1.0,1350,1.0,0,1350,0,1966,1
3,1.0,960,1.0,0,960,0,1982,1
2,1.0,1300,1.5,0,1300,0,1975,1
4,2.5,1810,1.0,0,1230,580,1970,1
2,1.0,1140,1.5,0,1010,130,2007,1
4,1.0,1450,1.0,0,1450,0,1943,1
3,2.0,1490,1.5,0,1490,0,1984,1
3,1.75,1620,1.0,0,1310,310,1988,1
4,2.5,1960,2.0,0,1960,0,2001,1
4,1.5,1930,2.0,0,1930,0,1979,1
2,1.0,1340,1.0,2,1340,0,1947,2
2,1.0,780,1.0,0,780,0,1946,2
3,1.0,1920,1.0,2,1120,800,1952,2
4,2.5,2210,1.0,2,1410,800,1965,2
4,2.5,1750,1.0,0,1240,510,1983,2
3,1.0,1010,1.0,0,1010,0,1947,2
3,2.0,1220,3.0,0,1220,0,2007,2
3,2.0,1270,3.0,0,1270,0,2006,2
5,1.75,2120,1.0,0,1320,800,1942,2
3,1.0,1800,1.0,0,1200,600,1942,2
4,2.5,2440,2.0,0,2440,0,1993,2
3,1.75,2420,2.0,0,2420,0,1911,2
3,2.0,1540,2.0,0,1540,0,2005,2
3,2.0,1650,1.5,0,1650,0,1983,2
3,1.5,1110,1.0,0,1110,0,1963,2
4,1.75,1830,1.0,0,1010,820,1966,2
4,2.5,2380,2.0,0,2380,0,2002,2
4,2.5,2560,1.0,0,1280,1280,1965,2
3,2.0,1630,1.0,0,1630,0,1987,2
3,2.0,1560,2.0,0,1560,0,1923,2
3,1.0,1670,1.5,0,1170,500,1939,2
3,1.75,1300,1.0,0,820,480,1919,2
3,1.75,1120,1.5,0,1120,0,1925,2
4,2.75,2430,1.0,0,2430,0,1967,2
3,1.75,1620,1.0,0,1190,430,1973,2
3,2.25,1670,2.0,0,1220,450,2002,3
2,1.0,1680,1.0,0,1140,540,1941,3
3,1.75,1680,1.0,0,960,720,1992,3
4,1.75,1814,1.0,0,944,870,1951,3
3,2.5,2210,2.0,0,2210,0,1994,3
4,3.0,2830,2.0,0,2830,0,1987,3
3,2.5,2510,2.0,0,2510,0,1992,3
3,2.0,1830,1.0,0,1830,0,1959,3
3,1.0,1430,1.0,0,1080,350,1919,3
4,2.0,3510,1.0,2,2210,1300,1965,3
5,2.5,3840,2.0,0,3840,0,1991,3
3,2.5,1620,3.0,4,1470,150,2008,3
3,2.0,1670,1.5,0,1670,0,1931,3
3,2.75,1960,1.5,0,1410,550,1926,3
3,1.0,1500,1.0,0,1000,500,1947,3
3,2.5,2600,1.0,0,2600,0,1984,3
4,2.75,2250,1.0,0,1200,1050,1951,3
4,4.0,2290,1.5,0,1690,600,1940,3
3,2.75,1800,1.0,0,1320,480,1966,3
4,2.0,1590,1.0,0,1590,0,1951,3
4,2.5,2560,2.0,0,2560,0,1987,3
3,2.5,2390,2.0,0,2390,0,1984,4
4,2.5,2380,2.0,0,2380,0,1991,4
4,2.75,3500,2.0,0,3500,0,2005,4
4,2.25,2530,1.0,0,1570,960,1976,4
4,2.0,2840,1.0,0,1420,1420,1952,4
5,3.25,3400,2.0,0,3400,0,1999,4
4,3.0,3680,1.0,3,2060,1620,1967,4
3,4.0,4380,2.0,0,4380,0,1983,4
4,3.5,4740,2.0,0,4740,0,2003,4
4,3.0,3370,1.0,3,1860,1510,1988,4
4,3.5,4390,2.0,3,3060,1330,1990,4
2,1.0,720,1.0,0,720,0,1943,1
3,1.75,1260,1.0,0,1260,0,1994,1
4,1.5,2670,2.0,0,2670,0,1996,2
4,1.75,1960,1.0,0,1340,620,1979,2
3,2.5,2460,2.0,0,2460,0,2007,2
3,1.0,1370,1.5,0,1370,0,1924,2
3,2.5,1740,2.0,0,1740,0,1989,2
4,2.5,3670,2.0,0,3670,0,2005,4
4,4.25,5584,2.0,0,5584,0,1998,4
3,1.75,1570,1.0,0,1570,0,1991,1
3,2.5,1560,2.0,0,1560,0,2003,1
4,3.5,2630,1.5,3,1640,990,1984,2
3,2.5,1620,1.0,0,1620,0,1955,2
3,3.0,2980,1.0,0,1820,1160,1981,3
3,1.0,1140,1.0,0,1140,0,1972,1
3,1.0,1140,1.0,0,1140,0,1960,1
4,2.5,2100,2.0,0,2100,0,2009,2
3,2.5,1780,2.0,0,1780,0,2001,2
3,1.5,1690,1.0,0,1140,550,1956,2
2,1.5,2730,1.0,0,1570,1160,1976,2
4,2.5,2700,2.0,0,2700,0,2004,3
3,2.0,2130,1.0,0,2130,0,1989,4
2,1.0,1180,1.0,0,1180,0,1918,1
3,1.0,910,1.0,0,910,0,1971,1
3,1.0,960,1.0,0,960,0,1955,1
3,2.0,1630,1.0,0,1630,0,2003,1
3,2.5,1658,2.0,0,1658,0,2014,1
3,2.5,1440,1.0,0,1000,440,1983,1
4,2.0,1930,1.0,0,1030,900,1967,1
3,1.75,1670,1.0,0,1320,350,1987,1
3,1.0,1200,1.0,0,920,280,1943,1
3,2.5,1680,1.0,0,1240,440,1994,1
4,2.5,1982,2.0,0,1982,0,2004,1
5,3.0,2840,1.0,0,1710,1130,2003,1
5,1.0,1410,1.0,0,960,450,1955,1
3,1.0,900,1.0,0,900,0,1972,2
4,1.0,2100,1.0,0,1050,1050,1968,2
3,1.5,1255,3.0,0,1255,0,2004,2
4,2.5,1630,2.0,0,1630,0,2003,2
3,1.75,1320,1.0,0,1320,0,1948,2
3,1.75,1780,1.0,0,1780,0,1983,2
2,1.0,880,1.0,0,880,0,1942,2
3,1.0,1810,2.0,0,1810,0,1970,2
4,2.5,1720,1.0,0,1120,600,1961,2
3,1.0,1600,1.0,0,1150,450,1964,2
4,2.0,2330,1.0,0,1400,930,1941,2
2,1.5,1180,2.0,0,990,190,2005,2
4,2.25,1810,2.0,0,1810,0,2003,2
3,1.0,1570,1.0,0,1570,0,1954,2
3,1.0,1050,1.5,0,1050,0,1954,2
2,2.25,1280,2.0,0,1080,200,2009,2
3,1.5,2000,1.0,0,1520,480,1965,2
3,1.75,1440,1.0,0,1440,0,1973,2
5,2.0,2330,1.0,0,1190,1140,1962,2
4,2.5,2870,2.0,0,2540,330,1979,2
3,3.0,1296,3.0,0,1296,0,2009,2
2,1.0,1470,1.0,0,1470,0,1940,2
3,1.75,1980,1.0,0,1310,670,1949,2
2,1.0,910,1.0,0,910,0,1942,2
3,2.25,1950,1.0,0,1350,600,1964,2
5,1.5,1900,1.0,0,1130,770,1961,2
3,2.5,1870,2.0,0,1870,0,2003,2
3,1.0,1270,1.5,2,1270,0,1928,2
3,1.75,1650,1.0,0,1650,0,1961,2
4,2.5,2520,2.0,0,2520,0,1999,2
4,3.25,2510,2.0,0,2510,0,2009,2
3,2.0,1460,1.0,0,1460,0,1975,2
3,2.5,2420,2.0,0,2420,0,1998,2
3,1.75,1840,1.0,0,1050,790,1925,2
3,3.5,1600,2.0,0,1240,360,2006,2
3,2.0,1560,1.0,0,1560,0,1967,2
2,1.0,1160,1.0,0,860,300,1942,2
4,2.75,1720,2.0,0,1720,0,1978,2
3,1.0,1150,1.0,2,1150,0,1943,2
3,2.5,1590,3.0,0,1590,0,1985,2
4,2.25,1940,1.0,0,1430,510,1956,2
3,2.5,1750,3.0,0,1750,0,2013,2
3,3.5,1820,2.0,0,1430,390,2014,2
3,2.25,1760,2.0,0,1760,0,1988,3
4,2.5,3200,2.0,0,3200,0,2005,3
5,3.0,2750,1.5,0,1750,1000,1926,3
4,2.5,2340,2.0,0,2340,0,1921,3
4,4.25,1960,2.0,0,1960,0,1940,3
5,4.5,4850,2.0,0,4850,0,2001,3
3,1.75,1930,1.0,0,1930,0,1977,3
3,1.75,1850,1.0,0,1850,0,1983,3
3,3.5,2710,2.0,0,1650,1060,2005,3
4,2.5,2740,2.0,0,2740,0,1990,3
3,2.5,2540,2.0,1,2540,0,1940,3
3,2.5,2810,2.0,0,2810,0,2001,3
4,3.0,3000,1.5,3,1970,1030,1913,3
2,2.5,2160,1.0,0,2160,0,2002,4
3,1.5,2500,1.5,2,1450,1050,1940,4
3,2.5,2330,2.0,4,1410,920,2004,4
5,2.75,3390,2.0,0,3390,0,2004,4
2,2.0,1880,1.5,0,1880,0,1902,4
3,2.5,2610,2.0,0,2610,0,2014,4
4,2.5,3330,2.0,0,3330,0,2009,4
3,3.0,2520,1.5,0,1560,960,1925,4
4,2.5,2680,1.0,0,1380,1300,1952,4
4,2.5,1850,1.0,0,1430,420,1978,4
4,3.0,3720,2.0,0,3720,0,1991,4
5,4.0,3720,2.0,0,3720,0,2005,4
3,3.75,3250,2.0,2,2370,880,1951,4
5,3.0,3480,2.0,0,3480,0,1964,4
3,2.25,2510,1.5,2,1810,700,1932,4
4,2.5,2920,1.0,3,1470,1450,1921,4
4,3.0,5940,2.0,4,4950,990,2004,4
3,3.25,3790,2.0,4,3790,0,1985,4
5,4.5,4590,2.0,0,4590,0,2009,4
2,1.0,780,1.0,0,780,0,1948,1
2,1.0,720,1.0,0,720,0,1942,1
3,1.0,820,1.5,0,820,0,1910,1
2,1.0,740,1.0,0,740,0,1949,1
3,1.0,1100,1.0,0,1100,0,1969,1
2,1.0,830,1.0,0,830,0,1996,1
3,1.5,1430,1.0,0,1430,0,1953,1
2,2.0,1390,2.0,0,1390,0,1986,1
2,2.0,1700,1.0,0,850,850,1927,1
2,1.5,880,2.0,0,880,0,2007,1
2,1.0,1320,1.0,0,1320,0,1943,1
3,1.75,1210,1.0,0,1210,0,1983,1
3,1.5,1560,1.0,0,1040,520,1964,1
3,2.0,2030,1.0,0,1220,810,1979,1
3,2.5,1680,2.0,0,1680,0,1994,1
4,2.25,1830,1.0,0,1200,630,1989,1
3,1.75,1310,1.0,0,1310,0,1979,1
3,2.5,2060,2.0,0,2060,0,1999,1
3,1.75,1300,1.0,0,1300,0,1996,1
3,2.0,1400,1.0,0,1400,0,1968,1
3,2.0,1480,1.0,0,1480,0,1992,1
2,1.0,1060,1.0,0,1060,0,1952,1
3,1.5,1430,1.0,0,1430,0,1966,1
3,2.5,2495,2.0,0,2495,0,2007,1
3,1.75,1300,1.0,0,650,650,1918,1
4,1.0,1450,1.0,0,990,460,1964,1
3,1.0,1180,1.5,0,1180,0,1946,1
2,1.0,800,1.0,0,800,0,1954,1
3,1.0,1390,1.5,0,1390,0,1954,1
3,1.0,1160,1.0,0,1160,0,1968,2
3,2.5,1680,2.0,0,1680,0,1984,2
3,1.0,1430,1.5,0,1430,0,1927,2
2,2.5,1050,2.0,0,1050,0,2005,2
3,2.75,1720,1.0,0,1720,0,1958,2
4,2.0,1480,1.0,0,740,740,1910,2
3,2.25,2180,2.0,0,2180,0,1986,2
2,1.0,1080,1.0,0,1080,0,1940,2
3,2.5,2400,1.0,0,2400,0,1990,2
2,1.0,1270,1.0,0,960,310,1920,2
4,2.5,3753,2.0,0,3336,417,2008,2
3,1.5,1300,1.0,0,1300,0,1963,2
3,2.0,1660,1.0,0,1660,0,1949,2
3,2.5,2250,2.0,0,2250,0,2006,2
3,1.75,1820,1.0,0,1250,570,1977,2
4,2.75,1680,1.0,0,1080,600,1979,2
2,1.75,1350,1.0,0,1350,0,2005,2
3,3.75,3890,1.0,2,2390,1500,1943,2
3,1.75,1980,1.0,0,1270,710,1965,2
4,3.0,4260,2.0,2,4260,0,2000,2
3,1.75,1610,1.0,0,1610,0,1947,2
3,1.0,1100,1.0,0,1100,0,1917,2
3,2.0,1300,1.0,0,900,400,1993,2
4,3.0,2230,2.0,0,2230,0,1991,2
6,3.25,4250,1.0,3,2150,2100,1967,2
3,2.25,1840,2.0,0,1840,0,2003,2
2,3.25,1400,3.0,0,1400,0,2000,2
3,2.0,1980,1.0,0,1980,0,1994,2
4,2.5,2360,2.0,0,2360,0,2003,2
4,2.5,2798,2.0,0,2798,0,2012,2
4,1.5,2040,1.0,0,1020,1020,1961,3
3,1.75,1400,1.0,0,870,530,1951,3
4,2.5,2680,2.0,0,2680,0,2004,3
2,1.75,2050,1.0,0,2050,0,1950,3
3,2.5,1720,2.0,0,1720,0,1994,3
3,2.5,1550,2.0,0,1550,0,1999,3
4,2.5,2230,1.0,0,1450,780,1974,3
4,1.0,1660,1.0,0,930,730,1933,3
3,2.5,3160,2.0,0,2650,510,2006,3
7,4.5,4140,1.0,0,2070,2070,1978,3
5,2.0,1940,1.0,0,970,970,1945,3
3,2.0,1650,2.0,0,1650,0,1926,3
4,2.75,2020,1.0,0,1010,1010,1917,3
4,2.0,2510,1.0,0,2510,0,1960,3
3,1.75,1580,1.0,0,1150,430,1967,3
4,2.5,2740,2.0,0,2740,0,1993,3
3,2.5,2300,1.5,0,2000,300,1921,3
4,2.5,2990,2.0,0,2990,0,2003,3
3,2.5,2190,2.0,0,2190,0,1987,3
3,1.0,1700,1.5,0,1700,0,1907,3
4,2.5,3150,2.0,0,3150,0,2006,3
4,3.5,4490,2.0,0,3390,1100,2006,3
2,1.75,2320,1.5,2,1720,600,1925,4
3,2.5,2810,2.0,0,2810,0,2005,4
4,2.25,2920,2.0,0,2920,0,1998,4
2,1.75,2080,1.0,0,1080,1000,1923,4
4,3.5,3910,2.0,0,3130,780,2007,4
4,2.25,2000,2.0,0,2000,0,2001,4
3,2.5,2510,2.0,2,2510,0,1995,4
4,2.5,3420,2.0,0,3420,0,2000,4
4,2.75,3040,2.0,0,2100,940,1906,4
3,2.0,2520,1.5,0,1410,1110,1906,4
3,2.75,2280,1.0,0,1280,1000,1917,4
5,1.5,2680,1.0,0,1450,1230,1963,4
6,2.75,2300,1.5,0,2300,0,1950,4
3,2.5,2690,2.0,0,1840,850,1943,4
4,2.25,2410,2.0,2,1800,610,1929,4
6,2.75,3610,1.0,4,2070,1540,1959,4
7,4.0,3150,1.0,0,3150,0,1957,4
4,2.75,3650,2.0,2,2530,1120,1951,4
4,2.5,3240,1.0,0,2260,980,1946,4
4,3.25,4700,1.0,4,2520,2180,2005,4
3,1.0,1010,1.0,0,1010,0,1954,1
3,1.0,1250,1.0,0,1030,220,1949,1
2,1.0,1500,1.5,0,880,620,1928,1
3,1.75,1590,2.0,0,1590,0,1986,1
2,1.0,950,1.0,0,950,0,1958,1
4,2.0,1530,2.0,0,1530,0,1942,1
3,1.5,1270,1.0,0,1270,0,1964,1
2,1.0,1110,1.0,0,1110,0,1951,1
3,1.5,1470,1.0,0,1470,0,1958,1
4,2.25,1720,1.0,0,1120,600,1978,1
4,1.75,1880,1.0,0,1180,700,1978,1
3,1.75,1590,1.0,2,1090,500,1957,1
4,2.5,2290,2.0,0,2290,0,2001,1
3,2.5,2080,2.0,0,2080,0,1989,2
2,1.0,820,1.0,0,820,0,1916,2
2,2.25,1000,3.0,0,1000,0,2006,2
2,1.0,810,1.0,0,810,0,1919,2
3,1.5,1460,1.0,0,1100,360,1971,2
3,2.25,2270,1.0,0,1380,890,1977,2
4,1.75,1700,1.0,0,1120,580,1981,2
4,2.5,2040,2.0,0,2040,0,2011,2
2,1.0,1320,1.5,0,1320,0,1909,2
5,2.0,1930,1.0,0,1020,910,1962,2
4,1.5,1390,1.0,0,1140,250,1965,2
4,2.0,1670,1.0,0,1670,0,1955,2
4,2.75,1240,1.0,0,800,440,1987,2
5,1.75,1880,1.0,0,960,920,1963,2
3,2.0,1240,1.0,0,1240,0,1988,2
3,1.75,2930,1.0,0,2030,900,1993,2
3,1.75,1950,1.0,0,1950,0,1985,2
2,1.0,1260,1.0,0,1040,220,1951,2
4,1.75,1990,1.5,0,1190,800,1944,2
4,2.0,2240,1.0,0,1120,1120,1956,2
4,2.25,2590,1.0,0,1340,1250,1968,2
6,2.5,4410,1.0,2,2350,2060,1965,2
3,1.0,2110,1.0,0,1110,1000,1924,2
4,2.75,2320,2.0,0,2320,0,2012,2
4,1.0,1600,1.5,0,1600,0,1916,2
3,2.0,2590,2.0,0,1980,610,1988,3
3,1.5,2240,2.0,0,1370,870,1929,3
3,3.0,2600,1.5,3,1890,710,1989,3
5,2.5,2630,2.0,0,2630,0,2003,3
3,1.0,1590,1.0,0,1590,0,1944,3
3,1.5,2600,1.0,0,1400,1200,1940,3
5,2.0,2450,1.0,0,1240,1210,1900,3
4,2.5,2440,2.0,0,2440,0,1996,3
3,2.0,1480,1.0,0,750,730,1928,3
4,2.5,2760,2.0,0,2760,0,1999,3
4,2.0,2300,1.5,0,1550,750,1915,3
4,1.75,1640,1.0,0,920,720,1921,3
3,3.25,1730,2.0,2,1320,410,2008,3
3,2.5,2930,2.0,0,2930,0,2008,3
4,2.75,3310,2.0,0,3310,0,2008,3
3,2.5,2620,2.0,0,2620,0,1992,3
4,2.75,2620,2.0,0,2620,0,2000,3
3,2.25,2330,1.5,2,1520,810,1927,3
3,1.75,1940,1.0,1,1440,500,1960,3
4,2.5,2920,2.0,0,2920,0,1990,3
3,2.5,2390,2.0,0,2390,0,2006,3
4,2.25,1960,1.0,0,1290,670,1959,4
5,3.0,2170,1.5,0,1450,720,1911,4
5,3.25,2900,1.0,0,1890,1010,1967,4
4,2.25,2280,1.5,2,1960,320,1940,4
3,2.5,2770,2.0,0,2770,0,1991,4
4,3.5,4140,2.0,0,4140,0,2000,4
4,4.25,4960,2.5,0,3680,1280,1909,4
2,1.5,1220,1.5,0,1220,0,1976,1
4,1.0,1290,1.5,0,1290,0,1957,1
3,2.25,1590,1.0,0,1090,500,1978,1
3,2.0,1560,1.0,0,1560,0,1992,1
3,2.0,2120,1.0,0,2120,0,1991,1
3,2.0,1330,1.0,0,630,700,1900,1
2,1.0,1000,1.0,0,1000,0,1942,1
3,1.75,1050,1.0,0,1050,0,1980,1
2,1.0,1880,1.0,0,940,940,1919,1
2,1.0,1090,1.0,0,730,360,1942,1
3,1.0,1210,1.0,0,1210,0,1955,1
3,2.5,2260,2.0,0,2260,0,1994,2
3,2.0,1060,1.0,0,1060,0,1981,2
4,2.5,2280,2.0,0,2280,0,1994,2
3,1.75,2180,1.0,0,1090,1090,1961,2
3,2.25,1490,2.0,0,1490,0,2009,2
2,2.5,1240,2.0,0,1240,0,2007,2
3,2.5,2200,2.0,0,2200,0,1990,2
3,2.0,1550,1.0,0,1150,400,1959,2
3,1.0,1200,1.0,0,1200,0,1971,2
3,2.5,1860,2.0,0,1860,0,2000,2
3,1.0,1220,1.0,0,1220,0,1901,2
4,2.5,2910,2.0,0,2910,0,2002,2
2,1.75,1340,1.0,0,1340,0,2004,2
3,1.75,1510,1.0,0,1240,270,1989,2
3,1.75,1680,1.0,2,840,840,1900,2
3,2.25,1820,1.0,0,1260,560,1974,2
5,2.75,2220,1.0,0,1230,990,1973,2
5,2.5,3090,1.0,0,2990,100,1957,2
3,1.75,2580,1.0,0,1290,1290,1951,2
4,2.25,1820,1.0,0,1340,480,1977,2
3,1.75,1920,1.0,2,960,960,1947,2
4,2.75,2620,2.0,0,2620,0,2013,2
3,2.5,1950,2.0,0,1950,0,1988,3
4,2.5,2720,2.0,0,2720,0,2012,3
3,1.5,2000,1.0,0,2000,0,1953,3
4,2.0,2340,1.0,0,1170,1170,1966,3
4,3.25,4240,2.0,3,3550,690,1989,3
3,2.5,2670,1.0,0,2670,0,1987,3
4,2.5,2560,2.0,0,2560,0,1992,3
2,1.0,1890,1.5,0,1890,0,1909,3
2,2.5,1740,2.0,2,1210,530,1994,3
4,2.25,2060,1.0,0,1440,620,1983,3
4,2.5,3190,1.0,0,2210,980,1946,3
4,2.5,2310,1.5,0,1490,820,1927,4
4,1.75,3420,1.0,3,1770,1650,1947,4
4,3.0,2840,1.5,0,2060,780,1931,4
5,3.75,3990,2.0,0,3090,900,1937,4
4,2.75,2600,1.0,0,1560,1040,1976,4
4,2.5,2310,2.0,0,2310,0,2013,4
3,2.5,2780,2.0,0,2780,0,2009,4
7,4.5,4290,1.5,0,4290,0,1982,4
3,2.25,3060,2.0,0,3060,0,1983,4
4,3.5,3760,2.0,0,2860,900,2014,4
4,1.75,2500,1.0,0,1500,1000,1970,4
4,2.5,3150,2.0,0,3150,0,1966,4
6,2.75,5700,1.0,4,2850,2850,1977,4
3,2.5,1960,2.0,0,1960,0,2004,1
5,2.75,2080,2.0,0,2080,0,1987,3
4,2.5,2550,2.0,0,2550,0,1992,3
3,2.25,1760,3.0,0,1760,0,2014,3
3,2.25,2675,2.0,0,2675,0,1984,3
3,2.5,2460,2.0,0,2460,0,1996,3
3,1.75,1790,1.0,0,1040,750,1960,1
1,1.0,750,1.0,0,750,0,1918,1
3,1.75,1620,1.0,0,1090,530,1974,2
4,1.75,2780,2.0,0,2780,0,1978,3
4,3.5,3480,2.0,0,2580,900,1926,4
3,1.0,1010,1.0,0,1010,0,1969,1
4,2.0,1850,1.0,0,1540,310,1978,1
4,2.5,1920,2.0,0,1920,0,1998,1
3,1.0,1450,1.0,0,1050,400,1958,1
3,2.0,1380,1.0,0,1380,0,2008,1
2,2.5,1380,2.0,0,1140,240,2011,1
3,2.5,2080,2.0,0,2080,0,2002,1
3,2.5,1950,2.0,0,1950,0,2010,1
4,2.5,2070,2.0,0,2070,0,2003,2
3,1.0,950,1.0,0,950,0,1950,2
2,1.5,1140,2.0,0,1140,0,1988,2
3,1.0,960,1.0,0,960,0,1952,2
3,2.25,2130,1.0,0,1570,560,1987,2
5,2.5,3020,1.0,0,1510,1510,1978,2
3,1.5,1320,1.0,0,1320,0,1970,2
2,2.5,1175,2.0,0,740,435,2005,2
3,1.75,1990,1.0,1,1320,670,1963,2
3,2.5,2680,2.0,0,2680,0,1990,2
3,1.75,1510,1.0,0,1510,0,1967,2
2,1.0,1210,1.0,0,1060,150,1950,2
3,2.25,1410,2.0,0,1290,120,2004,2
3,2.5,1495,3.0,0,1405,90,2006,2
3,1.5,2030,1.0,0,1330,700,1963,2
2,1.75,1710,2.0,0,1330,380,1920,2
4,1.75,1790,1.0,0,1490,300,1969,2
4,2.75,2150,1.0,0,1240,910,1976,2
3,2.5,2240,2.0,0,2240,0,2002,2
3,1.5,1120,1.0,0,1120,0,1956,2
2,2.0,1410,1.5,0,1410,0,1909,2
4,2.75,2340,1.0,0,1720,620,1967,2
2,1.0,1170,1.0,0,970,200,1941,2
3,1.75,1890,1.0,0,1290,600,1965,2
3,1.0,950,1.5,0,950,0,1948,2
3,2.0,1750,1.0,0,1490,260,1982,2
3,1.75,2770,1.0,0,1580,1190,1978,2
3,2.0,1720,1.0,2,960,760,1941,3
4,2.5,2910,2.0,2,2910,0,2006,3
3,2.5,1690,2.0,0,1690,0,1984,3
4,1.75,1720,1.5,0,1460,260,1925,3
5,2.75,2910,1.0,0,1590,1320,1977,3
3,1.5,1790,1.5,1,1790,0,1910,3
3,2.0,1810,1.5,0,1810,0,1925,3
3,2.75,2930,1.0,0,1860,1070,2004,3
3,2.75,2180,1.0,0,1310,870,1981,3
4,2.5,2220,2.0,0,2220,0,1988,3
5,2.5,3990,1.0,0,1990,2000,1962,3
4,2.5,2150,2.0,0,2150,0,1985,3
3,2.0,1760,1.0,0,960,800,1920,3
3,2.5,1960,1.0,0,980,980,1940,3
4,2.5,2430,1.0,0,1670,760,1963,3
3,2.5,2290,2.0,0,2290,0,2006,3
4,2.25,1990,1.5,2,1420,570,1932,3
4,2.5,2720,2.0,0,2720,0,1987,3
4,2.5,2710,2.0,0,2710,0,1999,3
3,2.25,2610,2.0,0,2610,0,1988,3
3,2.5,1840,1.0,0,920,920,1926,3
3,1.5,1840,2.0,0,1840,0,1961,3
4,2.75,3270,2.0,0,3270,0,2014,4
4,2.5,3190,2.0,2,3190,0,2001,4
4,2.0,2360,1.0,0,1260,1100,1939,4
3,3.0,3740,2.0,2,3740,0,1991,4
2,2.5,2210,1.0,0,2210,0,2003,4
3,1.75,2160,1.0,0,1390,770,1960,4
4,3.0,4500,2.0,2,3040,1460,1980,4
3,2.25,3020,2.0,0,2720,300,1969,4
3,2.5,2730,2.0,0,2730,0,1998,4
5,3.25,3160,2.0,0,3160,0,1972,4
3,1.0,1200,1.0,0,1200,0,1969,1
3,1.0,1040,2.0,0,1040,0,1942,1
2,2.5,1240,2.0,0,1240,0,1986,1
3,1.5,1180,1.0,0,1180,0,1960,1
3,1.0,1060,1.0,0,1060,0,1962,1
3,1.0,1110,1.0,0,1110,0,1962,1
3,2.0,1200,1.0,0,1200,0,1995,1
3,1.0,1030,1.0,0,1030,0,1961,1
3,2.0,1440,1.0,0,720,720,1942,1
2,1.0,940,1.0,0,940,0,1952,1
3,1.0,1250,1.0,0,1250,0,1959,1
3,2.0,1530,1.0,0,1530,0,1970,1
2,1.0,720,1.0,0,720,0,1947,1
3,1.75,1340,1.0,0,1340,0,1968,1
3,2.25,1765,2.0,0,1765,0,1996,1
2,1.75,1220,1.0,0,860,360,1921,1
3,1.75,1970,1.0,0,1970,0,1966,1
3,1.75,1590,1.5,0,1590,0,1926,1
3,2.0,1410,1.0,0,1410,0,1983,1
2,1.5,1480,1.0,0,1480,0,1940,1
2,1.0,1170,1.0,0,1170,0,1963,1
5,2.75,2481,2.0,0,2481,0,2014,2
4,2.5,1830,2.0,0,1830,0,2003,2
3,2.25,1540,1.0,0,770,770,1954,2
3,2.0,1880,1.0,0,940,940,1952,2
3,3.25,1530,2.0,0,1140,390,2013,2
3,1.75,2250,1.0,0,2250,0,1980,2
3,2.5,1950,2.0,0,1950,0,1990,2
5,2.75,2670,2.0,0,2670,0,2014,2
4,2.5,2240,2.0,0,2240,0,2014,2
6,1.5,2550,1.0,0,1750,800,1958,2
3,2.0,1080,1.0,0,1080,0,1947,2
3,1.5,1200,1.0,0,1200,0,1962,2
3,2.25,1450,2.0,0,1450,0,2009,2
3,3.25,2780,2.0,0,2780,0,2009,2
2,1.75,1370,1.0,0,1370,0,1944,2
3,1.75,1660,1.0,0,1380,280,1981,2
3,2.25,1870,1.0,0,1440,430,1978,2
3,2.25,1660,1.0,0,1110,550,1979,2
2,2.5,1140,3.0,0,1140,0,2007,2
3,3.0,2340,2.0,0,2340,0,2013,2
4,2.25,1790,1.0,0,1110,680,1973,2
3,2.0,1360,1.5,0,910,450,1924,2
3,2.5,1970,2.0,0,1970,0,2003,2
3,1.75,2220,1.0,0,1110,1110,1988,2
3,2.25,1680,2.0,0,1680,0,1989,2
2,1.0,1230,1.0,0,1130,100,1906,2
5,2.75,2040,1.0,0,1200,840,1969,2
4,2.5,3030,2.0,0,2020,1010,1998,2
3,2.25,1800,1.0,0,1800,0,1976,2
3,2.5,2600,2.0,0,2600,0,1989,2
4,2.25,2220,1.0,0,1110,1110,1961,2
3,1.75,1620,1.0,0,830,790,1945,3
3,2.5,2190,2.0,0,2190,0,1999,3
4,2.25,2290,2.0,0,2120,170,1958,3
3,1.75,1810,1.5,0,1810,0,1903,3
3,2.5,2110,2.0,0,2110,0,2001,3
4,2.5,2170,1.0,0,1460,710,1980,3
3,1.75,2000,1.0,0,1400,600,1963,3
3,2.25,2090,2.0,0,2090,0,1983,3
3,2.25,3800,1.0,0,3330,470,1976,3
4,2.75,3120,2.0,0,3120,0,2010,3
4,2.5,3150,2.0,0,3150,0,2014,3
4,4.25,2360,2.0,0,2360,0,1939,3
4,2.0,2580,1.0,0,1300,1280,1950,3
4,2.5,2620,2.0,0,2620,0,1987,3
4,2.5,1960,1.0,1,1290,670,1958,3
3,2.0,2060,1.0,0,1120,940,1947,3
5,2.5,2070,1.0,0,1340,730,1967,3
3,2.5,2370,2.0,0,2370,0,1993,3
5,2.75,2550,1.5,0,2550,0,1902,3
4,2.5,2790,2.0,0,2790,0,1987,3
3,2.5,2290,3.0,0,2290,0,1953,3
5,2.75,3040,2.0,0,3040,0,1993,3
3,2.75,2390,1.0,0,1390,1000,1942,3
4,2.5,2961,2.0,0,2961,0,1998,3
3,2.0,2140,1.0,0,1070,1070,1928,4
3,1.5,1660,1.0,0,1660,0,1956,4
3,2.0,2050,1.0,0,2050,0,1951,4
4,2.5,2870,2.0,0,2870,0,1986,4
3,2.5,2430,2.0,0,2430,0,1987,4
5,1.0,2550,2.5,0,2550,0,1905,4
4,2.25,3720,1.0,2,1860,1860,1970,4
2,2.5,2680,1.0,0,2680,0,2006,4
5,3.5,3490,2.0,4,2460,1030,1980,4
4,3.0,4590,2.0,0,3490,1100,1981,4
4,3.75,4130,2.0,0,4130,0,2001,4
1,1.0,650,1.0,0,650,0,1967,1
1,1.0,790,1.0,0,790,0,1942,1
4,1.75,1720,1.0,0,1220,500,1974,1
2,1.0,1500,1.0,0,1500,0,1950,1
2,1.0,670,1.0,0,670,0,1919,1
5,2.0,1750,1.0,0,1750,0,1943,1
3,1.0,920,1.0,0,920,0,1977,1
3,2.25,1500,1.0,0,1150,350,1984,1
3,1.75,1730,1.0,0,1730,0,1972,1
3,1.75,1460,1.0,0,990,470,1997,1
4,2.0,2120,1.5,0,2120,0,1960,1
3,2.0,1710,2.0,0,1710,0,1988,1
3,1.5,1810,1.0,0,950,860,1983,1
3,2.25,2080,1.5,0,1550,530,2003,1
3,2.5,1720,1.0,0,1000,720,1983,1
2,1.0,770,1.0,0,770,0,1948,1
2,1.0,960,1.0,0,960,0,1942,1
3,2.5,2437,2.0,0,2437,0,2011,1
3,2.0,1670,1.0,0,1670,0,1992,1
3,2.0,1350,1.0,0,1110,240,1995,2
3,1.0,1010,1.0,0,1010,0,1959,2
3,1.5,1650,1.0,0,1130,520,1978,2
3,1.0,1210,1.0,0,1210,0,1949,2
4,1.75,1650,1.0,0,1650,0,1968,2
3,1.0,1070,1.0,0,1070,0,1989,2
4,2.75,2540,1.0,0,1600,940,1979,2
3,1.75,2190,2.0,0,2190,0,1978,2
2,1.75,1650,1.0,0,950,700,1947,2
4,2.5,2310,2.0,0,2310,0,1978,2
2,1.0,1250,1.0,0,1250,0,1947,2
3,1.5,1420,1.0,0,1420,0,1959,2
4,1.75,2200,1.0,0,1100,1100,1955,2
2,1.0,820,1.0,0,820,0,1922,2
3,2.25,1250,1.0,0,1250,0,1942,2
3,1.0,1240,1.0,0,1240,0,1952,2
4,2.5,2150,2.0,0,2150,0,2005,2
3,1.5,2080,1.0,0,1190,890,1959,2
3,2.0,2260,1.0,0,1130,1130,1986,2
3,1.75,1530,1.0,0,1530,0,1986,2
3,1.75,1840,1.0,0,1040,800,1952,2
4,2.5,2000,2.0,0,2000,0,1999,2
3,2.5,2060,2.0,0,2060,0,2007,2
4,2.5,2460,2.0,0,2460,0,2003,2
2,1.75,1500,1.0,0,910,590,1942,2
5,2.5,2300,1.0,0,1170,1130,1967,2
3,1.75,1420,3.0,0,1420,0,2006,2
3,2.0,1800,1.0,0,1800,0,1956,2
3,2.5,2340,1.0,0,2340,0,1985,2
3,2.5,1520,2.0,0,1040,480,2007,2
5,3.0,2920,2.0,0,2920,0,2003,3
3,3.25,1540,2.0,0,1540,0,2011,3
3,2.0,1540,1.0,0,1540,0,2004,3
4,1.75,2020,1.0,0,1430,590,1979,3
3,2.5,1820,2.0,0,1820,0,1993,3
3,2.5,1710,2.0,0,1570,140,2005,3
5,2.5,2730,1.0,0,1660,1070,1958,3
4,2.25,2740,2.0,0,2740,0,1991,3
4,2.75,3370,2.0,0,3370,0,1991,3
3,2.5,2070,2.0,0,2070,0,1996,3
5,2.5,2650,1.0,0,1400,1250,1961,3
3,2.25,1830,1.0,0,1290,540,1986,3
6,2.75,2630,1.0,0,1650,980,1974,3
3,2.5,1780,3.0,0,1600,180,2006,3
4,2.5,4060,1.0,4,2150,1910,1977,3
4,3.5,2910,2.0,0,2910,0,2012,3
4,2.25,2500,1.0,0,1600,900,1978,3
4,2.5,3290,2.0,0,3290,0,2008,3
3,2.25,2560,2.0,0,2560,0,1986,3
4,2.5,2770,2.0,0,2770,0,1989,3
3,2.25,2370,1.0,0,1650,720,1973,4
4,2.5,2730,2.0,0,2730,0,1986,4
3,2.0,1990,1.0,0,1130,860,1912,4
4,3.0,4410,2.0,0,3400,1010,2006,4
3,2.25,2430,2.0,0,1810,620,1989,4
4,2.5,2700,2.0,0,2700,0,1994,4
3,3.25,4720,2.0,2,3190,1530,1998,4
3,1.75,2090,2.0,0,1610,480,1947,4
4,2.75,3790,2.0,0,3790,0,1999,4
4,2.5,2770,2.0,0,2770,0,1987,4
5,3.5,3280,2.0,0,2440,840,2003,4
5,2.75,2660,1.0,4,1470,1190,1969,4
5,3.5,3880,2.0,3,2540,1340,1979,4
3,1.0,1010,1.0,0,1010,0,1958,1
4,1.5,1920,1.0,0,1370,550,1959,1
2,2.5,1150,2.0,0,1150,0,2004,1
2,1.0,1190,1.0,0,830,360,1941,1
3,1.0,1130,1.0,0,1130,0,1954,1
4,2.5,2068,2.0,0,2068,0,1976,1
3,1.0,1150,1.0,0,1150,0,1957,1
3,2.5,1510,1.0,0,1030,480,1976,1
3,2.5,1610,2.0,0,1610,0,1994,1
4,2.75,2330,1.0,0,1800,530,1990,1
4,2.5,2100,2.0,0,2100,0,2006,1
3,1.0,1690,1.0,0,1020,670,1967,1
3,1.5,1890,1.0,0,1090,800,1957,1
3,1.0,1500,1.0,0,1500,0,1968,1
3,3.0,1390,2.0,0,1140,250,2006,1
3,2.0,1750,1.0,0,1350,400,1961,1
3,2.0,1680,1.0,0,1680,0,1993,1
5,2.5,2490,1.0,0,1490,1000,1989,1
4,2.5,1910,2.0,0,1910,0,2005,1
4,1.75,1560,1.0,0,1560,0,1965,1
3,2.5,1660,2.0,0,1660,0,2009,2
4,2.5,2610,2.0,0,2610,0,2009,2
3,2.0,1170,1.0,0,1170,0,1919,2
4,2.5,2070,2.0,0,2070,0,2004,2
3,2.5,2600,2.0,0,2600,0,2004,2
2,1.0,920,1.0,0,920,0,1914,2
4,2.5,2390,2.0,0,2390,0,1999,2
3,1.5,1180,1.0,0,800,380,1981,2
3,1.75,960,1.0,0,960,0,1962,2
4,2.75,2420,2.0,0,2420,0,2005,2
3,2.25,1710,1.0,0,1210,500,1978,2
3,2.0,1463,3.0,0,1463,0,2003,2
4,3.0,1980,1.0,0,1160,820,1983,2
3,1.75,1460,1.0,0,1460,0,1961,2
4,2.5,2658,2.0,0,2658,0,2014,2
3,2.0,1330,1.0,0,1330,0,1969,2
4,2.75,2440,2.0,1,2440,0,1957,2
3,1.75,1980,1.0,1,1090,890,1910,2
4,2.5,2340,2.0,0,2340,0,2008,2
3,2.5,2170,2.0,0,2170,0,2003,2
4,1.0,2000,1.5,0,1250,750,1916,2
4,1.75,2000,1.0,2,1300,700,1959,2
4,1.75,1670,1.0,0,1670,0,1947,2
3,2.25,1530,2.0,0,1050,480,2014,2
3,1.0,1430,1.0,0,950,480,1945,2
3,2.5,1480,2.0,0,1480,0,1996,2
4,3.75,2810,2.0,2,2070,740,1994,2
5,3.0,2440,1.0,0,1450,990,2006,2
3,3.5,1690,2.0,0,1360,330,2008,2
3,2.5,2520,1.5,0,2520,0,1988,2
3,2.5,2370,2.0,0,2370,0,2001,2
4,3.25,4160,2.0,0,2760,1400,1973,3
4,2.25,2210,2.0,0,2210,0,1968,3
4,2.25,2980,1.5,2,2020,960,1935,3
4,2.25,1330,1.5,0,1330,0,1962,3
3,1.75,1700,1.5,0,1700,0,1931,3
3,2.5,1480,1.0,0,1480,0,1968,3
4,2.5,2700,2.0,0,2700,0,2007,3
4,2.75,2020,1.0,0,1420,600,1976,3
4,2.5,2260,2.0,0,2260,0,2003,3
3,2.75,2390,1.0,0,1360,1030,1977,3
3,2.5,1640,2.0,0,1640,0,1992,3
4,1.75,1830,2.0,0,1230,600,1990,3
4,1.75,1660,1.5,0,1660,0,1926,3
4,2.25,2400,1.5,0,1460,940,1929,3
4,3.75,4610,1.0,0,2500,2110,1980,3
3,1.75,2340,1.0,0,1170,1170,1917,3
3,2.5,2680,1.0,0,1610,1070,1979,3
3,2.5,2050,2.0,0,2050,0,2011,4
3,1.75,1910,1.0,0,1080,830,1959,4
4,2.75,2420,1.0,0,1530,890,1977,4
3,2.5,2670,2.0,0,2670,0,1987,4
4,2.75,3110,2.0,0,3110,0,1983,4
4,2.25,2070,1.0,0,1700,370,1967,4
3,3.5,3590,2.0,0,3590,0,1999,4
4,3.5,3500,2.0,0,2500,1000,1994,4
3,3.5,3250,2.0,0,2500,750,2001,4
5,2.5,2920,2.0,0,2320,600,1906,4
4,2.0,2660,1.5,0,1480,1180,1923,4
5,4.75,5180,2.0,2,4070,1110,2001,4
6,4.5,3902,3.0,4,2782,1120,1977,4
4,5.25,4670,2.0,0,4670,0,1989,4
3,1.0,1840,1.0,0,920,920,1953,1
2,1.0,810,1.0,0,810,0,1948,1
4,2.25,1900,1.0,0,1900,0,1975,1
5,2.5,2690,2.0,0,2690,0,2012,1
2,1.0,780,1.0,0,780,0,1943,1
3,2.0,1970,1.0,0,1300,670,1967,1
4,2.5,2680,2.0,0,2680,0,1999,1
3,1.5,1750,1.0,0,1150,600,1954,2
3,2.5,3080,2.0,0,3080,0,1990,2
3,1.75,1370,1.0,0,1370,0,1983,2
3,1.75,1020,1.5,0,1020,0,1953,2
4,1.0,1550,1.5,0,1550,0,1954,2
3,1.0,1560,1.0,0,1560,0,1953,2
2,1.5,1490,1.0,0,930,560,1956,2
3,2.5,2700,1.0,3,1350,1350,1959,2
2,2.0,1405,2.0,0,1140,265,2007,2
4,2.0,1880,2.0,0,1880,0,1978,2
3,1.75,1910,1.0,0,1340,570,1977,2
4,2.25,2070,2.0,0,2070,0,1977,2
3,1.75,1470,1.0,3,1070,400,1939,2
2,1.0,1260,1.5,0,1260,0,1926,2
4,2.0,1470,1.0,0,1470,0,1965,2
3,2.5,1480,2.0,0,1480,0,2005,2
2,1.75,1740,1.0,0,990,750,1946,2
4,1.75,2050,1.0,0,1250,800,1959,2
4,2.25,1740,1.0,0,1170,570,1958,2
3,2.5,2030,2.0,0,1720,310,2001,2
4,1.0,1720,1.5,0,1720,0,1904,3
3,1.75,1480,1.0,0,1480,0,1974,3
4,1.5,1320,1.0,0,1320,0,1954,3
5,2.75,2440,1.0,0,1240,1200,1972,3
3,1.5,1730,2.0,0,1730,0,1983,3
3,2.0,2260,1.0,0,1780,480,1985,3
4,2.5,2040,2.0,0,2040,0,1990,3
3,1.5,1900,1.5,0,1640,260,1926,3
3,2.5,2400,2.0,0,2400,0,1993,3
4,2.5,2430,2.0,0,2430,0,2008,3
4,2.5,2630,2.0,0,2630,0,2008,3
4,2.5,1990,2.0,0,1680,310,2005,3
4,2.5,2560,2.0,0,2560,0,2001,3
4,2.5,2840,2.0,0,2840,0,1990,3
3,1.75,1980,1.5,0,1140,840,1926,3
3,2.25,2270,1.0,0,1820,450,1975,3
3,2.5,2550,2.0,0,2550,0,1990,4
4,2.75,3010,2.0,0,3010,0,2014,4
4,2.5,2820,2.0,0,2050,770,2013,4
4,3.0,2720,2.0,0,1800,920,1919,4
3,2.5,2670,2.0,0,2670,0,1986,4
5,2.5,4600,1.0,3,2300,2300,1956,4
4,2.0,2230,1.5,0,2230,0,1959,4
2,2.0,2280,1.0,0,2280,0,2002,4
5,2.75,3030,2.0,0,3030,0,2014,4
4,3.0,3240,2.0,0,3240,0,2013,4
4,2.75,2880,1.5,0,1710,1170,1928,4
4,2.5,4150,2.0,0,4150,0,2014,4
4,3.25,3450,2.0,3,2430,1020,1960,4
5,2.75,4400,1.0,3,2250,2150,1963,4
4,3.5,3010,2.0,0,2370,640,1999,4
4,4.0,4270,2.0,3,3180,1090,2004,4
4,3.5,4280,2.0,0,4280,0,2005,4
4,2.5,3070,2.0,0,3070,0,2006,2
3,3.0,1730,3.0,0,1730,0,1985,2
4,2.5,2460,2.0,0,2460,0,1998,3
6,2.5,3820,1.0,0,2040,1780,1974,3
4,2.5,1811,2.0,0,1811,0,2007,1
2,1.0,1440,1.0,0,960,480,1915,2
3,1.0,1300,1.5,0,1300,0,1927,2
4,2.25,2450,2.0,0,2450,0,1976,3
3,2.75,3400,2.0,2,2470,930,2009,3
5,3.0,2870,2.0,0,2090,780,2007,3
4,2.5,1780,2.0,0,1780,0,1994,3
3,2.5,2300,2.0,0,2300,0,2001,3
4,2.25,2370,2.0,0,2370,0,1979,3
4,1.75,1980,1.0,0,1480,500,1978,1
3,1.5,1150,1.0,0,1150,0,1963,1
4,1.75,1300,1.0,0,1300,0,1969,1
3,1.0,1330,1.0,0,1330,0,1948,1
3,1.0,1590,1.5,0,1590,0,1944,1
3,1.75,1330,1.0,0,1330,0,1998,1
4,1.0,1910,1.5,0,1910,0,1934,1
5,1.5,2520,1.5,0,1510,1010,1928,1
3,2.25,2210,2.0,0,2210,0,1969,1
2,1.0,1200,1.0,2,1200,0,1917,1
4,2.0,2030,1.0,0,2030,0,1976,1
2,1.0,1000,1.0,0,1000,0,1960,1
4,2.75,1990,1.0,0,1270,720,1999,1
3,2.25,1680,2.0,0,1680,0,1987,1
3,1.5,1860,1.0,0,1200,660,1963,1
4,3.0,2390,2.0,0,2390,0,1974,1
4,2.5,1980,2.0,0,1980,0,2003,2
3,2.5,1480,2.0,0,1150,330,2010,2
3,2.0,1350,1.0,0,1350,0,1986,2
4,1.75,1920,1.0,0,1500,420,1975,2
2,1.5,1340,2.0,0,1120,220,2008,2
3,2.5,1210,3.0,0,1210,0,2008,2
3,1.75,1240,1.0,0,1240,0,1978,2
2,1.75,1060,2.0,0,960,100,2008,2
3,3.0,2500,2.0,0,2500,0,1997,2
3,2.5,1800,2.0,0,1800,0,2011,2
4,2.75,2190,2.0,0,2190,0,1993,2
3,1.75,1710,1.0,0,1710,0,1958,2
4,1.5,2020,1.0,0,2020,0,1960,2
3,1.75,1230,1.0,0,1230,0,1987,2
4,1.75,2700,1.5,0,2700,0,1968,2
3,2.5,1720,2.0,0,1240,480,2004,2
4,3.5,2370,2.5,0,2370,0,2013,2
2,1.0,1140,1.0,0,1140,0,1942,2
3,2.5,1960,2.0,0,1960,0,2006,2
3,1.0,1410,1.0,0,910,500,1956,2
3,2.0,1310,1.0,0,780,530,1986,2
3,2.25,1890,1.0,0,1230,660,1973,2
3,1.75,2240,1.0,0,1120,1120,1948,2
4,2.5,2170,2.0,0,2170,0,1992,2
3,1.75,1640,1.0,0,1110,530,1940,2
4,2.5,2330,2.0,0,2330,0,1998,2
4,2.75,1980,1.0,0,1980,0,1952,2
4,1.75,2220,2.0,3,2220,0,1964,2
3,3.5,1500,2.0,0,1240,260,2004,2
4,1.75,2240,1.5,0,2240,0,1965,3
3,1.75,1300,1.0,0,1300,0,1963,3
3,3.0,2470,2.0,0,2470,0,1980,3
3,2.5,1900,2.0,0,1900,0,2005,3
3,2.25,2190,1.0,1,1240,950,1963,3
4,2.5,2700,1.0,0,1440,1260,1968,3
3,2.5,2260,2.0,0,2260,0,2005,3
2,2.5,1380,3.0,0,1380,0,2006,3
3,1.75,1760,1.0,0,1760,0,1977,3
3,1.5,2070,1.0,0,1140,930,1948,3
4,2.5,2800,2.0,0,2800,0,2001,3
3,1.75,2050,1.0,0,1070,980,1977,3
2,2.0,1870,1.0,0,1870,0,2003,3
4,3.5,3730,2.0,2,2440,1290,1991,3
3,2.5,2630,2.0,0,2630,0,2004,3
3,2.5,2670,2.0,3,2670,0,1981,3
4,2.5,3190,2.0,0,3190,0,2006,3
3,2.5,2590,2.0,0,2590,0,2004,3
3,1.75,2210,1.0,0,1390,820,1958,3
3,2.5,2140,2.0,0,2140,0,1991,3
4,2.5,2380,2.0,0,2380,0,1992,3
4,2.5,2350,2.0,0,2350,0,1994,3
4,3.0,3150,2.0,0,3150,0,2000,4
4,2.5,2800,2.0,0,2800,0,1999,4
4,2.5,2610,2.0,0,2610,0,1988,4
4,3.25,2050,2.0,0,1370,680,1987,4
4,2.5,2030,1.5,0,1630,400,1926,4
3,2.5,2630,1.0,0,1580,1050,1967,4
4,2.25,3160,1.0,0,3160,0,1981,4
4,2.5,2730,1.5,0,2230,500,1909,4
3,2.5,2850,1.0,0,1730,1120,1954,4
4,2.5,2740,2.0,0,2740,0,1984,4
4,2.5,4250,2.0,2,3260,990,1972,4
4,3.25,3300,2.0,0,3300,0,1985,4
5,3.5,4220,1.0,0,2110,2110,1958,4
4,3.25,4130,2.0,0,4130,0,1978,4
4,1.0,1120,1.0,0,860,260,1939,1
4,1.0,1200,1.5,0,1200,0,1944,1
3,1.0,1010,1.0,0,1010,0,1959,1
3,1.0,970,1.0,0,970,0,1965,1
3,1.75,1330,1.0,0,1330,0,1973,1
3,1.0,920,1.0,0,920,0,1962,1
3,1.0,970,1.0,0,970,0,1967,1
3,1.75,1760,1.0,0,920,840,1979,1
3,1.75,1590,1.0,0,1130,460,1984,1
3,2.0,1320,1.0,0,1320,0,1975,1
3,1.75,2040,1.0,0,1020,1020,1962,1
2,1.0,1380,1.0,0,870,510,1943,1
3,2.5,1560,2.0,0,1560,0,2003,1
4,2.25,1940,2.0,0,1940,0,1990,1
2,2.0,1651,1.0,0,1651,0,1946,1
4,2.5,2009,2.0,0,2009,0,2014,2
2,1.5,1010,2.0,0,1010,0,1981,2
4,1.0,1150,1.5,0,1150,0,1947,2
3,2.5,1780,1.0,0,1230,550,1990,2
4,1.0,1740,1.5,0,1740,0,1965,2
3,1.75,1420,1.0,0,1100,320,1984,2
4,2.5,1930,2.0,0,1930,0,1992,2
2,1.0,1740,1.0,0,950,790,1924,2
3,1.75,2430,1.0,0,1410,1020,1978,2
3,1.75,1540,1.0,0,920,620,1955,2
2,0.75,1392,1.5,0,1392,0,1978,2
3,1.75,1890,2.0,0,1890,0,1952,2
4,2.0,1630,1.0,0,1630,0,1968,2
3,1.75,1520,1.0,0,1520,0,1976,2
4,2.5,1960,2.0,0,1960,0,2002,2
4,2.5,2210,2.0,0,2210,0,1999,2
3,1.5,1530,1.0,0,1530,0,1975,2
4,1.5,1680,1.0,0,1130,550,1959,2
4,1.75,1720,1.0,0,860,860,1971,2
4,2.75,1940,2.0,0,1940,0,1990,2
4,2.5,2530,1.0,0,1440,1090,1978,2
2,1.0,1100,1.0,0,1100,0,1926,2
3,2.5,2090,2.0,0,2090,0,2000,2
4,1.0,1390,1.5,0,1390,0,1941,2
3,2.5,2340,2.0,0,2340,0,1995,2
3,3.25,1410,3.0,0,1410,0,2005,2
3,1.5,2010,1.0,0,1570,440,1951,2
3,1.75,1870,1.0,0,1270,600,1959,2
5,2.25,1970,1.0,0,1450,520,1986,2
3,1.5,1290,3.0,0,1290,0,2000,2
2,1.0,1470,1.0,0,1020,450,1941,2
3,1.75,2290,1.0,0,1620,670,1965,2
5,2.5,2732,1.0,2,1870,862,1975,2
4,1.75,2320,1.0,0,1140,1180,1910,2
4,2.0,1210,1.0,0,1210,0,1955,2
4,2.5,3020,2.0,0,3020,0,1994,2
3,2.0,2220,2.0,0,1640,580,1980,2
3,2.5,1800,2.0,0,1800,0,1996,3
3,2.0,2110,1.0,0,1080,1030,1919,3
5,2.75,2880,2.0,0,2880,0,2006,3
4,2.75,2790,2.0,0,2790,0,2013,3
3,2.0,2180,1.5,2,1680,500,1930,3
4,2.0,2180,1.0,0,1020,1160,1900,3
4,1.75,2440,1.0,0,1340,1100,1954,3
5,3.0,3670,1.0,0,2060,1610,1952,3
4,2.0,2750,1.5,0,2250,500,1916,3
4,4.5,3870,2.0,0,2530,1340,2001,3
4,2.75,2490,1.0,0,1400,1090,1983,3
4,2.25,2560,2.0,0,2560,0,1973,3
3,1.75,2050,1.0,0,1460,590,1962,3
3,2.5,2510,2.0,0,2510,0,1996,3
3,1.75,1820,1.0,0,1620,200,1957,3
3,1.75,1760,1.0,0,1460,300,1960,3
3,2.5,2550,2.0,0,2550,0,2001,3
4,3.5,3510,2.0,0,3510,0,2001,3
3,2.75,2540,2.0,0,2540,0,2005,3
5,2.75,3100,2.0,2,3100,0,1950,4
3,2.0,2080,1.0,0,1160,920,1954,3
3,3.5,2440,2.0,0,1990,450,2000,4
3,2.5,3000,2.0,0,3000,0,1995,4
4,3.25,3490,2.0,0,3490,0,2006,4
5,3.25,2750,2.0,1,2150,600,1937,4
4,2.5,3700,1.0,4,2620,1080,1988,4
4,2.5,3340,2.0,1,2470,870,1998,4
5,2.5,2550,1.0,0,1610,940,1953,4
4,2.5,2580,2.0,0,2580,0,2013,4
6,3.75,2930,2.0,3,2930,0,2013,4
5,4.0,3760,2.0,0,3760,0,1983,4
5,3.25,3230,2.0,0,2480,750,2014,4
3,3.0,2940,2.0,0,2230,710,1988,4
5,3.75,3630,1.5,0,2470,1160,2004,4
4,2.5,3040,2.0,0,3040,0,2001,4
5,3.25,5270,2.0,1,4010,1260,1977,4
1,1.0,620,1.0,0,620,0,1939,1
2,1.0,700,1.0,0,700,0,1953,1
3,1.75,1570,1.0,0,1310,260,1977,1
3,1.0,1050,1.0,0,1050,0,1942,1
3,2.0,1640,1.5,0,1640,0,1910,1
3,1.5,1360,1.5,0,1360,0,1984,1
5,1.5,1510,1.0,0,1510,0,1959,1
2,1.5,982,2.0,0,806,176,2006,1
3,1.5,1160,1.0,0,1160,0,1962,1
2,1.0,1350,1.0,2,1350,0,1952,1
3,2.5,1860,2.0,0,1860,0,1989,1
3,2.5,1870,2.0,0,1870,0,2005,1
3,1.75,1520,1.0,0,1520,0,1968,1
2,1.0,860,1.0,0,860,0,1931,1
4,2.75,2414,2.0,0,2414,0,2006,1
5,3.5,2100,2.0,0,1410,690,1999,1
3,2.5,2250,2.0,0,2250,0,1994,2
3,1.0,1160,1.0,0,1160,0,1952,2
3,1.75,1790,1.0,0,1130,660,1978,2
3,2.5,2456,2.0,0,2456,0,2012,2
3,2.5,2210,2.0,0,2210,0,1989,2
2,1.0,720,1.0,0,720,0,1942,2
4,2.25,2030,1.0,0,1230,800,1963,2
3,2.5,1430,3.0,0,1430,0,2002,2
3,3.25,1460,2.0,0,1130,330,2006,2
3,1.75,1170,1.0,0,1170,0,1962,2
3,1.0,940,1.0,0,940,0,1965,2
3,1.0,890,1.0,0,890,0,1951,2
3,2.0,1370,1.0,0,1370,0,1964,2
3,1.5,1460,1.0,0,1460,0,1954,2
3,1.5,1270,2.0,0,1080,190,2004,2
3,2.0,1640,1.0,0,1640,0,1948,2
4,2.5,2550,2.0,0,2550,0,2009,2
4,1.0,1860,1.5,0,1860,0,1901,2
3,2.5,1420,3.0,0,1420,0,2004,2
4,2.5,2300,1.0,0,2300,0,1955,2
4,2.5,3170,2.0,2,3170,0,2001,2
3,2.0,2060,1.0,0,1030,1030,1929,2
4,2.5,2180,2.0,0,2180,0,1989,2
4,2.5,2090,1.0,0,1320,770,1965,2
4,1.75,1470,1.0,0,980,490,1955,2
3,2.25,1630,2.0,0,1630,0,2005,2
6,5.0,3440,2.0,0,3280,160,2007,2
3,1.75,1720,1.0,1,1220,500,1986,3
3,2.5,3370,2.0,0,3200,170,1951,3
4,3.5,2550,2.0,0,2550,0,2007,3
3,1.75,1730,1.0,0,1400,330,1980,3
2,1.75,1640,1.0,0,840,800,1921,3
3,1.75,1550,1.0,0,1050,500,1927,3
5,2.25,2520,2.0,0,2520,0,1978,3
3,2.5,2180,1.0,0,1850,330,1979,3
3,3.5,1650,3.0,0,1650,0,2010,3
3,2.5,1990,2.0,0,1990,0,2004,3
3,2.5,2600,2.0,0,2600,0,1988,3
4,2.75,2240,1.5,0,2240,0,1976,3
4,2.0,1680,1.0,0,980,700,1950,3
4,2.0,2090,1.5,0,1790,300,1927,3
4,2.75,4140,2.0,0,4140,0,2002,3
6,3.0,4250,2.5,0,3020,1230,1902,3
3,2.75,2500,1.0,0,1390,1110,1948,4
4,1.75,2460,1.5,0,1450,1010,1909,4
4,2.75,2490,2.0,2,1490,1000,1979,4
4,2.5,2810,2.0,0,2810,0,1997,4
3,1.75,2430,1.0,1,1230,1200,1949,4
3,3.5,4500,2.0,0,4500,0,2004,4
3,1.5,2210,1.5,0,2210,0,1916,4
4,3.75,2690,2.0,3,2120,570,1909,4
4,2.5,3280,2.0,0,3280,0,2001,4
4,2.75,3370,1.0,3,1920,1450,1948,4
3,2.5,2070,1.5,0,1270,800,1910,4
4,2.5,3320,2.0,0,2650,670,1977,4
4,2.5,3470,2.0,0,3470,0,1995,4
5,3.0,2510,1.5,3,1590,920,1925,4
4,2.5,3760,2.0,0,3760,0,1987,4
5,3.5,4210,2.0,3,4210,0,1995,4
5,6.25,8670,2.0,4,6120,2550,1965,4
2,1.0,820,1.0,0,820,0,1965,1
4,1.75,1200,1.0,0,1200,0,1968,1
4,1.5,1130,1.0,0,1130,0,1970,1
2,1.0,910,1.0,0,910,0,1957,1
2,1.0,1100,1.0,0,1100,0,1947,1
3,1.75,1840,1.0,0,1500,340,1985,1
4,2.5,1770,2.0,0,1770,0,2003,1
4,1.5,1490,2.0,0,1490,0,1966,1
4,2.5,2210,1.0,0,1490,720,1990,1
3,2.5,1970,2.0,0,1970,0,1988,1
3,3.25,1470,2.0,0,1180,290,2008,2
4,2.5,2490,2.0,0,2490,0,2001,2
5,3.0,1880,1.0,0,1100,780,1997,2
2,1.5,1070,2.0,0,1070,0,1999,2
3,2.5,1880,2.0,0,1880,0,1993,2
2,1.0,970,1.0,0,970,0,1908,2
4,2.5,1910,1.0,0,1910,0,1963,2
2,2.25,1170,2.0,0,1170,0,2009,2
3,2.0,2080,1.0,0,2080,0,2002,2
3,1.0,1060,1.0,0,1060,0,1966,2
4,2.25,2300,1.5,0,1340,960,1904,2
3,3.25,1651,2.0,0,1341,310,2008,2
2,1.0,1220,1.0,0,1220,0,1947,2
3,1.75,1800,1.0,0,900,900,1950,2
3,1.75,1590,1.5,0,970,620,1938,2
3,1.0,1180,1.0,0,1180,0,1948,2
3,1.0,1330,1.0,0,900,430,1984,2
4,1.75,1890,1.0,0,1110,780,1947,2
3,3.5,1240,2.0,0,1000,240,2008,2
5,3.5,3690,2.0,0,2540,1150,2006,2
3,1.0,1710,1.5,0,1200,510,1926,2
3,2.75,1560,1.0,0,1030,530,1972,2
5,1.75,2460,1.5,0,1340,1120,1911,2
2,1.5,1630,1.0,0,890,740,1940,2
5,2.0,1940,1.5,0,1940,0,1957,2
3,2.5,1250,3.0,2,1250,0,2005,2
4,2.5,2470,2.0,0,2470,0,1989,2
4,2.25,2640,1.0,0,2640,0,1986,2
4,2.5,2140,2.0,0,2140,0,2003,2
3,2.0,1769,1.0,0,1769,0,1955,2
5,2.75,2990,2.0,0,2990,0,1996,2
3,1.75,1970,1.0,3,1370,600,1976,3
3,1.75,1600,1.0,0,1600,0,1967,3
3,2.5,2120,2.0,0,2120,0,1988,3
3,1.0,1510,1.5,0,1510,0,1909,3
4,1.75,1880,1.5,0,1090,790,1944,3
3,2.25,1710,2.0,0,1710,0,2004,3
2,1.0,1510,1.5,0,1310,200,1935,3
4,2.5,3140,1.0,2,1770,1370,1966,3
5,2.0,2060,2.0,0,2060,0,1903,3
3,2.5,1910,2.5,0,1530,380,2007,3
4,1.75,1870,2.0,0,1200,670,1937,3
5,2.75,2820,1.0,0,1450,1370,1967,3
4,2.25,2180,2.0,0,2180,0,1984,3
2,1.0,1430,1.5,0,1300,130,1929,3
3,2.5,2480,2.0,0,2480,0,2000,3
4,2.0,2710,1.0,0,1460,1250,1919,3
3,3.0,2340,2.0,0,2160,180,1925,3
3,2.5,2050,1.0,3,1730,320,1956,3
3,2.0,2460,1.0,2,1370,1090,1952,3
3,2.5,2570,2.5,0,2570,0,2007,3
4,2.5,2683,2.0,0,2683,0,1987,3
4,2.5,3280,2.0,0,3280,0,1996,3
3,2.75,1900,1.0,0,1410,490,1942,4
3,1.75,2110,1.0,0,2110,0,1961,4
3,3.5,3950,1.5,0,2460,1490,1989,4
4,2.5,3010,2.0,0,3010,0,2005,4
4,3.25,2420,1.5,0,1870,550,1911,4
3,2.0,2420,1.0,1,1500,920,1979,4
3,3.0,2790,2.0,4,1600,1190,1977,4
4,3.25,3960,2.0,0,3960,0,2005,4
4,2.25,2460,1.0,0,2460,0,1957,4
4,2.5,2370,2.0,0,2370,0,2003,4
4,2.5,3270,2.0,0,3270,0,1989,4
0,0.0,3064,3.5,2,3064,0,1990,4
4,2.5,3200,1.5,1,1860,1340,1948,4
4,2.5,5730,2.0,4,4280,1450,1991,4
5,4.0,4410,2.0,0,4410,0,2006,4
4,3.75,4030,2.0,0,4030,0,2006,4
3,1.0,1270,1.5,0,1270,0,1944,1
3,1.0,1290,1.0,0,1290,0,1976,1
3,1.0,1340,1.0,0,1340,0,1978,1
2,1.75,1440,1.0,0,1440,0,1978,1
2,1.0,710,1.0,0,710,0,1943,1
2,1.0,930,1.0,0,930,0,1986,1
3,1.75,1900,1.0,0,950,950,1980,1
3,2.25,1400,2.0,0,1400,0,2012,1
4,2.5,1930,1.0,0,1120,810,1981,1
4,1.75,1900,1.0,0,1900,0,1958,1
3,1.75,1840,1.0,0,920,920,1905,1
3,1.75,1180,1.0,0,1180,0,1962,1
4,2.5,2700,1.0,0,1560,1140,1966,2
3,2.0,2020,1.0,0,1220,800,1957,2
3,1.0,1280,1.5,0,1280,0,1947,2
3,1.5,1210,1.0,0,610,600,1983,2
4,2.5,1880,2.0,0,1880,0,2000,2
3,2.5,2070,2.0,0,2070,0,1997,2
3,2.5,1070,2.0,0,720,350,2005,2
2,1.5,1800,1.0,0,1240,560,1987,2
3,1.75,1820,1.0,0,1230,590,1976,2
3,1.5,1650,1.0,0,1100,550,1961,2
4,2.5,2220,2.0,0,2220,0,2001,2
3,2.25,1410,2.0,0,1290,120,2005,2
4,2.5,2540,2.0,0,1870,670,2000,2
3,2.25,1920,1.0,0,1060,860,1921,2
4,2.5,2050,2.0,0,2050,0,2006,2
4,2.5,1750,2.0,0,1750,0,2009,2
4,2.5,2690,2.0,0,2690,0,1993,2
3,2.0,1910,1.5,0,1910,0,1971,2
3,1.75,1500,1.0,0,1500,0,1997,2
4,2.25,2010,1.0,0,1220,790,1974,2
4,2.25,2630,2.0,0,2630,0,1979,2
3,1.75,1850,1.0,2,1100,750,1919,2
3,2.25,1580,1.0,0,1200,380,1981,2
3,2.5,1580,2.0,0,1580,0,1985,2
3,1.75,1760,1.0,0,1230,530,1967,2
3,1.0,1830,1.5,0,1430,400,1926,2
4,2.75,2020,1.0,0,1010,1010,1958,3
3,1.0,1540,1.5,0,1200,340,1926,3
5,3.0,3610,2.0,0,3610,0,2003,3
3,1.75,1640,1.0,0,1090,550,1948,3
3,3.0,1384,2.0,0,1144,240,2006,3
3,2.5,2040,2.0,0,2040,0,1992,3
3,1.0,1870,1.5,0,1580,290,1927,3
4,3.0,2440,2.0,0,2440,0,1961,3
3,2.0,2250,1.0,0,1250,1000,1925,3
4,2.5,2010,2.0,0,2010,0,1989,3
3,1.75,2350,1.0,0,1800,550,1978,3
5,2.75,3320,2.0,0,2190,1130,1975,3
4,2.5,2790,2.0,0,2790,0,1989,3
4,2.75,3650,1.5,0,3650,0,1978,3
3,2.0,2910,2.0,0,1920,990,1900,4
5,2.5,3210,1.0,0,1830,1380,1968,4
3,2.5,2300,1.5,0,1510,790,1930,4
4,2.5,2420,1.0,4,1700,720,1958,4
4,2.0,3140,1.0,1,1940,1200,1939,4
4,3.5,3200,2.0,0,2670,530,2007,4
3,2.5,2860,2.0,0,2860,0,2000,4
3,1.75,1980,1.0,2,1320,660,1952,4
5,3.5,2320,2.0,0,1720,600,1926,4
4,2.5,4120,2.0,0,4120,0,1997,4
4,2.5,3670,2.0,0,3670,0,1999,4
4,2.25,2770,2.0,0,2770,0,1974,4
5,2.5,2350,2.0,0,2350,0,1993,4
4,2.5,3770,2.0,0,3770,0,1989,4
5,2.75,3100,1.0,2,1660,1440,1973,4
4,2.5,2750,2.0,0,1960,790,1905,4
5,1.5,2540,2.0,3,2340,200,1954,4
5,2.25,4200,2.5,0,2910,1290,1906,4
3,2.5,4310,1.5,4,2510,1800,1982,4
3,1.75,1430,1.0,0,1430,0,1950,2
3,2.0,1510,1.0,0,1070,440,1972,2
2,1.0,1980,1.0,0,1090,890,1923,2
4,2.75,2360,2.0,0,2360,0,2008,3
3,2.5,1930,2.0,0,1930,0,2005,3
4,2.75,2450,2.0,2,2450,0,2010,4
5,2.75,2920,1.0,0,1660,1260,1968,4
4,2.5,2960,2.0,0,2960,0,1985,4
3,2.5,1890,2.0,0,1730,160,2002,1
3,1.0,1110,1.0,0,1110,0,1957,2
5,3.0,2430,1.0,0,1370,1060,1957,3
3,2.0,1900,1.0,0,950,950,1940,3
3,1.75,2140,1.0,0,1290,850,1953,3
4,2.5,2700,2.0,0,2700,0,1990,3
3,1.5,1230,1.0,0,1230,0,1949,1
2,1.0,760,1.5,0,760,0,1947,1
3,1.5,1220,1.0,0,1220,0,1973,1
3,1.75,1070,1.0,0,1070,0,1957,1
4,2.5,2240,1.0,0,1370,870,1988,1
3,2.0,1410,1.0,0,1410,0,1940,1
3,1.75,1400,1.0,0,1400,0,1957,1
2,1.5,880,2.0,0,880,0,1999,1
2,1.0,1200,1.0,0,980,220,1943,1
3,1.0,1000,1.0,0,1000,0,1969,1
3,1.0,1100,1.0,0,1100,0,1957,1
3,2.5,1880,2.0,0,1880,0,2009,1
4,1.75,1960,1.0,0,1960,0,1967,1
3,1.75,1770,1.0,0,1030,740,1960,1
5,3.0,1940,1.0,0,1200,740,2007,2
4,2.0,1810,1.0,0,1110,700,1967,2
3,1.75,1150,1.0,0,1150,0,1979,2
3,2.25,1200,3.0,0,1200,0,2005,2
1,1.0,960,1.0,0,760,200,1908,2
3,1.5,2040,1.0,0,1340,700,1957,2
3,2.5,1212,3.0,0,1212,0,2004,2
4,1.75,1580,1.0,0,1130,450,1947,2
4,2.25,1760,2.0,0,1760,0,1987,2
2,1.75,1210,2.0,0,1210,0,2014,2
3,2.0,1530,1.0,0,1530,0,1977,2
3,1.0,1770,1.5,0,1140,630,1926,2
4,2.0,2400,2.0,0,2400,0,1913,2
4,2.0,1240,1.0,0,1040,200,1908,2
5,2.5,2760,1.0,0,1600,1160,1960,2
4,2.5,2960,2.0,0,2960,0,2006,2
3,2.0,1590,2.0,0,1590,0,2000,2
4,1.75,1690,1.0,0,870,820,1984,2
2,1.0,830,1.0,3,830,0,1928,2
4,2.0,1580,1.0,0,1580,0,1953,2
4,2.0,1800,1.0,0,1000,800,1923,2
4,3.0,2360,1.0,2,1460,900,1960,2
4,1.5,1220,1.0,0,1220,0,1965,2
5,2.5,2340,2.0,0,2340,0,2009,2
3,2.0,1980,3.0,0,1980,0,2007,2
3,2.5,2300,2.0,0,2300,0,2003,2
3,1.75,1890,1.5,3,1890,0,1976,2
6,2.25,3550,1.0,0,2960,590,1948,2
2,1.5,1310,1.5,0,1310,0,1970,2
3,1.75,1550,1.0,0,860,690,1949,2
3,2.25,2670,1.0,0,1640,1030,1966,2
3,2.5,1350,2.0,0,1120,230,2007,2
3,1.5,1760,1.0,0,1160,600,1958,2
3,1.5,1510,1.0,0,1510,0,1956,2
5,2.5,2570,2.0,0,2570,0,2006,2
3,1.75,1750,1.0,0,1470,280,1968,2
4,2.75,2280,1.0,0,2280,0,1960,3
3,1.75,1540,1.0,0,770,770,1947,3
4,2.5,1740,1.0,0,1220,520,1976,3
3,2.25,1420,3.0,0,1420,0,2006,3
4,2.5,2050,2.0,0,2050,0,1988,3
3,2.5,1700,2.0,0,1700,0,2005,3
4,2.5,2650,2.0,0,2650,0,2014,3
3,2.5,1940,1.0,2,1440,500,1975,3
4,2.25,2170,2.0,0,2170,0,1987,3
4,2.5,2120,2.0,0,2120,0,1985,3
4,2.5,2440,2.0,0,2440,0,2002,3
5,2.5,2640,2.0,0,2640,0,2003,3
3,2.5,2110,2.0,0,2110,0,2005,3
4,2.75,2610,3.0,0,1910,700,1910,3
6,1.75,1840,1.0,0,1060,780,1900,3
3,1.5,1720,2.0,0,1720,0,1907,3
4,2.75,2500,2.0,0,2500,0,2010,3
4,3.5,2840,3.0,0,2840,0,2008,3
2,1.75,1600,1.0,0,850,750,1918,3
4,3.5,2690,2.0,0,2690,0,2002,3
4,3.25,3430,2.0,0,3430,0,2014,4
3,2.5,3100,2.0,0,3100,0,2002,4
3,1.75,1990,1.0,0,1100,890,1939,4
3,2.75,2670,1.0,0,1720,950,2013,4
4,2.5,2810,1.0,0,1710,1100,1973,4
4,1.5,1890,1.5,0,1890,0,1919,4
4,3.5,4140,2.0,0,3160,980,2003,4
4,3.25,3450,2.0,0,3450,0,2014,4
4,2.5,3190,2.0,0,3190,0,1990,4
4,3.5,3290,2.0,1,2360,930,2006,4
4,2.5,3030,2.0,0,3030,0,2003,4
4,1.5,2220,1.0,0,1490,730,1954,4
4,3.5,3280,2.0,0,3280,0,2007,4
4,2.75,2800,2.0,0,2800,0,1992,4
4,4.0,3530,2.0,0,2630,900,1958,4
4,1.0,1920,1.0,0,1220,700,1966,1
3,1.0,1140,1.0,0,1140,0,1943,1
3,1.5,1180,1.0,0,1180,0,1977,1
3,1.5,1430,1.0,0,820,610,1980,1
4,1.75,1740,1.0,0,1180,560,1978,1
3,1.0,1320,1.0,0,1320,0,1967,1
1,1.0,930,1.0,0,930,0,1948,1
3,2.25,2110,1.0,0,1360,750,1973,1
3,2.0,1410,1.0,0,1410,0,1983,1
3,2.0,1570,2.0,2,1050,520,1971,1
3,1.75,1190,1.0,0,1190,0,1968,1
3,1.75,1280,1.5,0,1280,0,1988,1
3,1.75,1370,1.0,0,1370,0,1982,1
4,2.5,1800,2.0,0,1800,0,1998,1
3,1.75,1160,1.0,0,1160,0,1998,1
2,1.5,1088,2.0,0,1088,0,1983,1
3,1.5,880,1.0,0,880,0,1945,1
3,1.75,1700,1.0,0,1700,0,1987,1
3,2.0,1870,1.0,0,1270,600,1986,1
3,1.75,1440,1.0,2,1090,350,1958,1
3,1.5,1270,1.0,0,1150,120,1948,1
2,1.5,1480,1.0,0,940,540,1978,1
3,2.0,1380,1.0,0,1380,0,1989,1
4,2.25,1930,1.0,0,1360,570,1988,1
3,2.5,1413,2.0,0,1413,0,2011,1
4,2.5,1660,2.0,0,1660,0,1994,1
4,2.0,1870,1.5,0,1870,0,1956,2
3,1.0,860,1.5,0,860,0,1927,2
4,2.5,2610,2.0,0,2610,0,1987,2
3,1.75,1160,1.0,0,1160,0,1976,2
3,2.5,3040,2.0,0,3040,0,2003,2
3,2.5,1270,2.0,0,1270,0,2004,2
3,2.5,1530,1.0,0,1270,260,1993,2
2,1.0,740,1.0,0,740,0,1948,2
4,2.75,2250,1.0,0,1480,770,1975,2
3,2.5,1680,2.0,0,1680,0,2007,2
3,2.0,1380,3.0,0,1380,0,2013,2
2,2.5,1260,3.0,0,1260,0,2005,2
5,3.5,2800,2.0,0,2800,0,1995,2
4,2.5,2150,2.0,0,2150,0,1991,2
4,2.5,2210,2.0,0,2210,0,1993,2
2,2.5,1620,2.0,0,1620,0,2008,2
3,2.25,2140,2.0,0,2140,0,1986,2
3,1.5,1450,1.0,0,1010,440,1968,2
3,1.5,1880,1.0,0,1480,400,1968,2
4,2.0,1610,1.0,0,1610,0,1967,2
3,2.5,2890,2.0,0,2890,0,2000,2
3,2.0,1730,1.0,0,1370,360,1978,2
3,2.25,1230,2.0,0,1080,150,2009,2
2,1.0,1230,1.0,0,1230,0,1928,2
4,2.0,1450,1.5,0,1450,0,1962,2
4,2.5,2470,2.0,0,2470,0,1999,2
4,2.5,1670,2.0,0,1670,0,2005,2
4,1.5,1550,1.5,0,1350,200,1918,2
4,2.5,3250,2.0,0,3250,0,2009,2
2,2.0,1494,2.0,4,1494,0,1943,2
2,2.75,1430,2.0,0,995,435,2006,2
4,2.5,2340,2.0,0,2340,0,2001,2
3,2.5,1180,3.0,0,1180,0,2010,2
3,2.25,2280,1.0,1,1150,1130,1985,2
3,2.75,2300,2.0,0,2300,0,2008,2
4,1.75,2030,1.5,0,2030,0,1975,2
3,2.5,2970,2.0,0,2970,0,1998,2
3,1.75,2180,1.0,0,1480,700,1961,3
4,2.75,3070,2.0,0,3070,0,2006,3
4,2.25,1990,2.0,0,1990,0,1991,3
3,2.75,2750,1.0,2,1810,940,1978,3
4,2.25,2030,1.0,0,1590,440,1967,3
4,1.0,1720,1.5,0,1200,520,1926,3
2,2.5,1380,3.0,0,1380,0,2006,3
3,1.75,2240,2.0,0,2240,0,1976,3
3,2.0,2340,1.0,1,1170,1170,1971,3
5,1.0,1710,1.5,0,1320,390,1926,3
5,2.0,2700,1.0,0,1540,1160,1962,3
3,2.25,2010,2.0,0,2010,0,1985,3
3,2.5,2830,2.0,0,2830,0,1989,3
4,2.5,2490,2.0,0,2490,0,1983,3
3,2.5,2670,2.0,0,2670,0,2003,3
3,2.0,1880,1.0,0,1030,850,1927,3
4,2.75,2700,2.0,0,2700,0,1976,3
6,1.75,2740,1.0,3,1370,1370,1953,3
4,2.5,2650,2.0,0,2110,540,1988,4
4,2.75,2630,2.0,0,2630,0,1994,4
3,2.5,2300,1.0,0,2300,0,2005,4
4,2.5,2940,2.0,0,2940,0,1991,4
3,2.5,2590,2.0,0,2590,0,1988,4
7,4.25,3670,2.0,1,2800,870,1964,4
5,2.75,3010,2.0,0,3010,0,1994,4
4,3.5,3860,2.0,0,3120,740,1996,4
4,2.75,3150,1.0,0,2480,670,1986,4
5,3.5,3130,2.0,0,2570,560,2014,4
4,4.25,3010,2.0,3,1940,1070,1951,4
3,1.75,2960,1.0,2,1480,1480,1952,4
4,3.5,2650,2.0,0,2060,590,2001,4
4,3.5,4170,2.0,0,4170,0,2004,4
4,4.0,4420,2.0,0,4420,0,2013,4
3,3.5,4360,2.0,3,2960,1400,2008,4
6,1.0,1370,1.5,0,1120,250,1931,1
2,1.0,660,1.0,0,660,0,1915,1
1,1.0,720,1.0,0,720,0,1914,1
3,1.0,1080,1.5,0,1080,0,1900,1
2,1.5,1820,2.0,0,1820,0,1921,1
2,1.0,1080,1.0,0,1080,0,1958,1
3,1.75,1670,1.0,0,1170,500,1978,1
2,1.0,670,1.0,0,670,0,1942,1
3,2.0,1260,1.0,0,1260,0,1986,1
3,1.0,1130,1.0,0,1130,0,1958,1
2,1.0,790,1.0,0,790,0,1942,1
4,2.0,2030,1.5,0,1430,600,1947,1
4,1.75,1820,1.0,0,1080,740,1980,1
4,1.75,1770,1.0,0,1050,720,1983,1
4,1.5,2050,1.0,0,1050,1000,1963,1
3,2.25,1584,2.0,0,1584,0,2012,1
3,2.25,1720,1.0,0,1320,400,1969,1
5,1.75,2150,1.0,0,1460,690,1970,1
3,1.0,990,1.0,0,990,0,1960,1
4,2.5,2570,1.0,0,1590,980,1979,1
3,2.0,1380,1.0,0,1380,0,1966,1
5,2.5,2220,1.0,0,1110,1110,1968,1
3,2.5,1700,2.0,0,1700,0,2000,2
3,1.0,910,1.0,0,910,0,1971,2
3,2.25,1490,2.0,0,1220,270,2010,2
4,2.5,2660,1.0,0,1740,920,1960,2
3,2.5,1730,2.0,0,1730,0,1993,2
4,2.5,1820,2.0,0,1820,0,1994,2
3,2.75,2200,1.0,0,1280,920,1977,2
3,2.5,1600,2.0,0,1600,0,2005,2
2,1.0,940,1.0,0,940,0,1910,2
2,1.0,1100,1.0,0,1100,0,1954,2
3,2.5,2640,2.0,0,1680,960,1991,2
3,2.5,1950,2.0,0,1950,0,1997,2
3,3.25,1689,3.0,0,1689,0,2008,2
3,1.75,1050,1.5,0,950,100,1928,2
5,2.5,3600,1.0,0,2410,1190,1968,2
4,2.0,1970,1.0,0,1820,150,1961,2
4,2.5,2020,2.0,0,2020,0,2010,2
3,1.75,1270,1.0,0,1270,0,1952,2
3,2.0,1670,1.0,0,1170,500,1972,2
4,2.5,2410,2.0,0,2410,0,2000,2
3,1.75,1180,1.0,0,760,420,1928,2
3,1.75,1180,1.0,0,1180,0,1981,2
3,3.25,2770,2.0,0,1980,790,2006,2
3,1.75,1510,1.0,2,860,650,1925,2
5,2.5,2240,1.0,0,1140,1100,1966,2
3,1.75,1700,1.0,0,1230,470,1977,2
3,3.25,1380,3.0,0,1380,0,2008,2
2,2.5,1430,3.0,0,1410,20,2008,2
5,3.25,3850,2.0,2,3030,820,2002,3
4,1.75,1770,1.0,0,1170,600,1968,3
3,3.5,1360,2.0,0,1040,320,2007,3
4,2.5,2920,2.0,0,2920,0,2003,3
4,2.5,2610,2.0,0,2610,0,2008,3
3,2.0,2120,2.0,0,2120,0,2003,3
3,1.75,1930,1.0,0,1930,0,2013,3
4,2.5,2050,2.0,0,2050,0,1989,3
3,1.75,1970,1.0,0,1420,550,1963,3
3,2.5,1560,1.5,0,1360,200,1936,3
5,2.25,1870,1.0,0,1170,700,1961,3
3,1.75,2040,1.0,0,1120,920,1958,3
5,3.0,2795,2.0,0,2795,0,1996,3
2,2.0,1690,1.0,0,1690,0,2004,3
5,3.5,3260,2.0,0,3260,0,1969,3
4,2.5,2290,2.0,0,2290,0,1996,3
5,3.25,3160,2.0,0,3160,0,1980,3
4,2.5,3250,2.0,0,3250,0,2008,3
5,2.25,2480,2.0,0,2480,0,1978,3
4,2.5,1910,2.0,0,1910,0,1987,3
4,2.5,2807,2.0,0,2807,0,1996,3
5,2.75,2870,1.0,0,1650,1220,1976,3
3,1.75,2920,1.0,0,1620,1300,1981,3
3,3.0,3450,2.0,0,3450,0,1983,3
4,2.5,3210,2.0,0,3210,0,1995,3
4,1.75,1980,1.0,0,990,990,1948,4
3,2.5,2420,2.0,4,1690,730,1989,4
4,2.5,2790,2.0,0,2790,0,1997,4
3,2.25,2910,2.0,0,2910,0,1990,4
4,2.5,3170,2.0,0,3170,0,2008,4
4,3.5,3810,2.0,0,3810,0,1938,4
5,3.5,3450,1.0,0,2350,1100,1972,4
4,2.25,2190,2.0,0,1800,390,1918,4
4,2.5,3640,2.0,0,3640,0,1999,4
4,2.5,4270,1.0,0,2680,1590,1991,4
4,3.5,4680,2.0,0,3360,1320,2005,4
4,3.25,4290,1.0,3,2690,1600,1997,4
4,2.75,3870,2.0,0,3870,0,2005,4
6,5.0,6050,2.0,3,6050,0,2001,4
3,2.0,1340,1.0,0,920,420,1912,1
3,1.0,1330,2.0,0,1330,0,1905,1
3,1.5,1140,1.0,0,1140,0,1960,1
3,2.0,1440,1.0,0,1440,0,1983,1
3,1.75,1150,1.0,0,1150,0,1983,1
3,2.25,1640,1.0,0,1140,500,1984,1
3,1.0,1320,1.0,0,880,440,1961,1
3,1.75,1750,2.0,0,1750,0,1976,1
4,2.0,1790,1.0,1,1670,120,1960,1
4,2.0,2080,1.0,0,1040,1040,1950,1
3,1.0,1050,1.0,0,1050,0,1959,1
3,1.75,1840,1.0,0,1840,0,1966,1
4,1.75,1530,1.5,0,1530,0,1968,1
3,1.75,1860,1.0,0,1860,0,1971,1
3,1.0,1210,1.5,0,1210,0,1901,1
3,2.0,1300,1.5,0,1300,0,1933,1
4,2.5,3490,2.0,0,3490,0,2003,1
3,2.5,1800,2.0,0,1800,0,2011,2
4,1.5,1220,1.0,0,1220,0,1980,2
3,1.75,1900,1.5,0,1070,830,1903,2
2,1.0,920,1.0,0,920,0,1939,2
4,1.0,1940,1.5,0,1940,0,1947,2
3,2.5,2238,2.0,0,2238,0,2011,2
3,2.5,2480,2.0,0,2480,0,2004,2
3,2.0,2140,1.0,0,1480,660,1966,2
2,1.0,1620,1.0,0,850,770,1921,2
3,2.0,1430,1.0,0,1430,0,1945,2
4,2.5,2850,2.0,0,2850,0,2004,2
3,2.5,2160,1.5,0,1260,900,1909,2
4,2.25,2150,1.0,0,1090,1060,1963,2
3,1.75,2310,1.0,0,1630,680,1978,2
3,2.25,1600,1.0,0,1090,510,1979,2
4,1.0,1980,1.0,0,1430,550,1968,2
4,2.25,1820,1.5,0,1320,500,1930,2
2,1.0,1260,1.0,0,1260,0,1947,2
6,2.75,2520,1.0,0,1320,1200,1962,2
4,2.5,2640,2.0,0,2640,0,1987,2
3,1.75,1310,1.0,0,1310,0,1948,2
2,1.75,1440,1.0,0,1440,0,2005,2
3,1.75,1170,1.0,0,1170,0,1968,2
4,2.5,2400,2.0,0,2400,0,2003,2
3,1.75,1610,1.0,0,1610,0,1955,2
3,1.0,1320,2.0,0,1320,0,1900,2
3,2.0,1730,1.0,0,1730,0,1997,2
3,2.25,1820,2.0,0,1820,0,1983,2
3,1.75,1840,1.0,0,920,920,1910,2
3,2.5,2840,1.0,3,1870,970,1994,3
3,2.5,1610,2.0,0,1610,0,1996,3
2,1.0,1570,1.0,0,1150,420,1952,3
3,2.5,2120,2.0,0,2120,0,2003,3
4,2.5,2610,2.0,0,2610,0,1998,3
3,2.75,2020,1.0,0,1270,750,1954,3
5,3.75,3090,2.0,0,3090,0,2014,3
3,2.25,1240,3.0,0,1240,0,2008,3
4,2.25,2060,1.0,0,1320,740,1962,3
3,2.5,1940,1.0,0,970,970,1948,3
4,2.25,2160,1.0,0,2160,0,1969,3
4,2.5,2840,2.0,0,2840,0,2001,3
3,1.5,1470,2.0,0,1470,0,1907,3
3,2.5,2650,2.0,0,2650,0,1994,3
3,2.0,2540,1.0,0,2540,0,2007,3
4,2.25,3070,2.0,0,3070,0,1970,3
3,3.25,1530,3.0,0,1530,0,2006,3
4,3.25,2520,1.5,0,1550,970,1931,3
4,2.5,2270,1.0,0,1500,770,1972,3
4,2.5,2310,2.0,0,2310,0,2008,3
4,3.0,2620,1.0,0,1870,750,1956,3
4,2.5,2496,2.0,0,2496,0,1998,3
6,2.0,1670,1.0,0,900,770,1911,3
3,2.75,3200,2.0,0,3200,0,2004,4
4,2.5,2440,2.0,0,2440,0,1987,4
3,2.5,2320,1.0,0,2320,0,2008,4
4,2.5,2650,2.0,0,2650,0,2012,4
3,3.5,3390,2.0,0,3040,350,2012,4
4,2.25,2160,1.0,0,1080,1080,1947,4
4,2.75,3010,2.0,0,3010,0,1996,4
4,2.5,2590,2.0,0,2590,0,2001,4
4,2.25,2370,1.0,2,1440,930,1959,4
5,2.0,3530,1.5,0,3530,0,1925,4
2,2.5,2540,2.0,0,2540,0,2004,4
5,3.0,3330,2.0,0,2610,720,1977,4
3,2.5,2430,2.0,1,2430,0,1989,4
5,3.5,3990,2.0,0,3990,0,2001,4
4,3.5,3820,2.0,0,3280,540,1990,4
4,4.5,4750,2.0,2,3600,1150,2005,4
3,3.5,3870,2.0,0,2760,1110,2002,4
5,4.75,5990,2.0,4,4050,1940,2002,4
2,1.0,1020,1.0,0,1020,0,1948,1
3,2.25,1230,1.5,0,1230,0,1913,1
2,1.0,860,1.0,0,860,0,1949,1
3,1.0,1150,1.0,0,1150,0,1953,1
3,1.0,960,1.0,0,960,0,1960,1
2,2.0,1680,2.0,0,1680,0,1910,1
2,2.0,1310,2.0,0,1310,0,2004,1
3,1.0,1300,1.0,0,1300,0,1960,1
3,1.75,1880,1.0,0,1330,550,1985,1
1,1.0,800,1.0,0,680,120,1931,1
4,2.0,2200,1.0,0,1100,1100,1979,1
3,2.0,1470,1.0,0,1470,0,1987,1
4,2.0,1890,2.0,0,1890,0,1997,1
2,1.0,840,1.0,0,840,0,1948,2
3,2.5,1820,2.0,0,1820,0,1983,2
3,2.25,1860,2.0,0,1860,0,1995,2
3,2.0,1510,1.0,0,1510,0,1942,2
4,3.0,2240,2.0,0,2240,0,1992,2
3,2.5,2570,2.0,0,2570,0,2014,2
4,2.5,2040,2.0,0,2040,0,1996,2
2,1.0,1240,1.0,1,1000,240,1943,2
5,2.25,2290,1.0,0,1290,1000,1973,2
3,2.25,1940,1.0,0,1100,840,1981,2
4,2.5,2550,2.0,0,2550,0,2005,2
4,2.5,1890,1.0,0,1230,660,1978,2
3,1.5,1520,1.0,0,1020,500,1949,2
3,1.0,1160,1.5,0,1160,0,1910,2
3,1.0,1500,1.0,0,900,600,1925,2
4,2.5,2320,2.0,0,2320,0,1997,2
4,2.25,2420,1.0,0,1400,1020,1973,2
3,1.0,1430,1.5,0,1430,0,1950,2
3,1.0,1460,1.5,0,1460,0,2002,2
2,1.0,1260,1.0,0,690,570,1925,2
5,3.0,2630,2.0,0,1670,960,2013,2
5,2.75,2280,1.0,0,1300,980,1959,2
3,2.5,2540,2.0,0,2540,0,1999,2
3,2.25,1790,1.0,0,1290,500,1967,2
5,3.0,3110,1.0,0,1790,1320,1977,2
3,2.75,1910,1.0,0,1160,750,1979,2
4,2.5,2040,2.0,0,2040,0,1994,2
4,2.5,2510,2.0,2,2510,0,2006,2
3,2.0,1430,1.0,0,980,450,1947,2
4,2.25,2450,1.0,2,1650,800,1954,2
3,2.25,1470,2.0,0,1470,0,1985,2
3,1.5,1440,1.0,0,1440,0,1975,2
3,2.5,1870,2.0,0,1870,0,2003,2
3,1.75,1780,1.0,0,1210,570,1976,2
4,1.0,2080,1.0,0,1040,1040,1941,2
4,3.0,1630,1.0,0,1110,520,1990,2
4,2.25,2170,1.0,0,1300,870,1976,2
4,2.0,2120,1.0,0,1060,1060,1940,2
4,1.0,1360,1.5,0,1360,0,1917,3
3,2.25,1750,3.0,0,1750,0,2001,3
5,2.5,2200,1.5,0,1420,780,1916,3
4,2.75,3260,2.0,0,3260,0,2013,3
3,3.5,1890,2.0,0,1640,250,1999,3
3,2.75,3290,2.0,0,3290,0,1993,3
4,2.5,2620,2.0,0,2620,0,1996,3
3,2.5,1850,2.0,0,1850,0,1989,3
3,2.5,2440,2.0,0,2440,0,2014,3
4,2.5,2090,2.0,0,2090,0,1986,3
2,1.75,1760,1.0,0,880,880,1930,3
4,2.5,3040,2.0,0,3040,0,2003,3
4,3.25,3030,2.0,0,3030,0,1988,3
4,2.25,2870,2.0,1,2220,650,1926,3
5,2.75,3260,1.0,0,1630,1630,1964,3
4,2.5,3290,2.0,0,3290,0,2003,4
3,3.5,3690,2.0,0,3690,0,2001,4
4,3.25,3940,2.0,3,3440,500,2000,4
6,1.75,2380,2.0,0,2380,0,1917,4
2,2.5,2770,2.0,0,2770,0,2006,4
4,2.5,2970,2.0,0,2970,0,2014,4
3,2.25,2140,2.0,0,2140,0,1905,4
4,1.75,2050,1.0,3,1450,600,1974,4
4,2.75,3150,2.0,0,3150,0,2004,4
3,3.25,3240,2.0,0,3240,0,2001,4
5,2.25,2780,2.0,0,2780,0,1978,4
3,2.25,2870,2.0,0,2250,620,1995,4
4,3.0,3740,2.0,0,3060,680,1988,4
3,2.25,2060,1.0,0,1610,450,1975,4
4,3.5,2970,2.0,0,2340,630,1997,4
3,3.25,2660,2.0,0,2170,490,2003,4
4,2.75,3730,2.0,0,3730,0,2012,4
4,2.0,3140,1.0,0,2040,1100,1959,4
3,3.25,3050,1.0,4,1650,1400,1962,4
4,2.5,3360,2.0,0,3360,0,1988,4
3,2.75,2470,2.0,0,2470,0,1960,4
4,2.25,2870,1.5,0,1980,890,1905,4
4,4.5,3850,2.0,2,3000,850,1998,4
3,3.0,4910,2.0,0,4000,910,1989,4
6,4.25,6900,2.0,0,4820,2080,2002,4
5,3.25,3240,1.5,4,2500,740,1939,4
7,5.5,6630,2.0,0,4930,1700,2004,4
5,4.0,3366,2.5,2,2966,400,1937,4
4,3.5,4410,2.0,0,4410,0,1989,4
5,3.25,3840,3.0,3,2750,1090,2008,4
7,3.5,4640,2.0,1,2860,1780,1965,4
2,1.0,1230,2.0,0,830,400,1948,2
4,1.5,1550,1.0,0,1000,550,1956,2
4,1.75,1780,1.0,0,890,890,1943,2
4,2.25,2330,2.0,0,2330,0,1986,3
3,1.75,2610,1.5,0,1680,930,1934,4
4,2.0,2160,1.5,1,2160,0,1928,4
3,2.5,3290,2.0,0,3290,0,2000,4
4,2.5,2380,2.0,0,2380,0,1999,2
4,2.5,2580,2.0,0,2580,0,2004,2
4,2.5,2040,1.0,0,1420,620,1963,3
4,2.5,2090,2.0,0,2090,0,1990,3
4,2.5,2370,2.0,0,2370,0,1966,3
4,2.5,2130,1.0,0,1230,900,1963,4
3,1.75,2870,1.5,0,1840,1030,1907,4
4,2.5,2810,2.0,0,2810,0,1989,4
4,3.5,3530,2.0,1,2570,960,1987,4
3,1.5,1270,2.0,0,1270,0,2012,1
3,1.0,1200,1.0,0,1200,0,1943,1
5,2.5,1740,1.0,0,1740,0,1959,1
3,1.5,1090,1.0,0,1090,0,1968,1
2,1.75,880,1.0,0,880,0,1945,1
3,2.0,1340,1.0,0,1340,0,1931,1
3,1.75,1580,1.0,0,1580,0,1967,1
3,2.25,1650,2.0,0,1650,0,1985,1
2,1.0,870,1.0,0,870,0,1940,1
6,3.0,2180,2.0,0,2180,0,1980,1
4,1.75,1450,1.5,0,1180,270,1962,1
3,1.0,1170,1.0,0,1170,0,1968,1
3,1.75,1230,1.0,0,1230,0,1984,1
3,1.0,1000,1.0,0,1000,0,1968,1
2,1.75,1500,1.0,0,1500,0,1963,1
3,2.0,1310,1.0,0,1310,0,1990,1
4,2.5,2000,2.0,0,2000,0,1989,1
3,1.75,1390,1.0,0,1390,0,1962,1
3,1.75,1760,1.0,0,1760,0,1966,1
3,1.0,1620,1.5,0,1620,0,1928,1
3,1.75,1840,1.0,0,1240,600,1976,1
4,2.5,2540,2.0,0,2540,0,1977,1
2,1.0,1180,1.0,0,1180,0,1949,1
3,1.0,1080,1.0,0,1080,0,1952,1
2,1.0,1010,1.0,0,1010,0,1925,1
3,2.5,1660,2.0,0,1660,0,2003,1
3,2.75,1100,2.0,0,780,320,2008,1
3,1.0,1150,1.0,0,990,160,1932,1
2,2.0,1610,2.0,0,1610,0,1930,1
3,1.0,880,1.5,0,880,0,1946,1
2,1.0,1060,1.0,0,1060,0,1951,1
4,2.5,2620,2.0,0,2620,0,2008,2
4,2.5,1840,2.0,0,1840,0,2004,2
3,2.5,2540,2.0,0,2540,0,2006,2
5,3.0,2300,2.0,0,2300,0,2013,2
3,2.5,2280,2.0,0,2280,0,1998,2
4,2.25,2010,2.0,0,2010,0,1975,2
4,1.75,2110,1.0,0,1170,940,1975,2
3,1.0,1030,1.0,0,1030,0,1969,2
3,2.5,2242,2.0,0,2242,0,2011,2
4,1.5,1150,1.5,0,1150,0,1970,2
3,1.75,1310,1.0,0,1310,0,1993,2
3,1.5,1420,2.0,0,1140,280,2008,2
3,1.0,1140,2.0,0,1140,0,1904,2
3,3.75,1950,1.0,0,1360,590,1959,2
3,2.5,2110,2.0,0,2110,0,1989,2
3,1.75,1270,1.0,0,880,390,1950,2
3,1.0,1270,1.0,0,1270,0,1955,2
3,2.0,2420,1.0,0,1210,1210,1949,2
7,3.0,2800,1.0,2,1400,1400,1963,2
3,1.75,1660,1.5,0,1660,0,1957,2
4,1.5,1720,1.0,0,1720,0,1953,2
3,2.5,2430,2.0,0,2430,0,1997,2
2,1.5,940,2.0,0,940,0,2009,2
4,2.0,1940,1.0,0,1940,0,1962,2
4,2.5,1870,2.0,0,1870,0,1990,2
2,1.0,880,1.0,0,880,0,1950,2
4,2.75,2700,2.0,0,2700,0,1984,2
3,3.25,1630,3.0,0,1630,0,2007,2
3,1.75,1880,1.0,0,1880,0,1959,2
3,1.75,2390,1.0,0,1350,1040,1955,2
3,1.75,1560,1.0,0,810,750,1940,2
4,1.75,1700,1.5,0,1340,360,1965,2
2,0.75,1020,2.0,0,1020,0,2009,2
3,1.0,1830,1.0,0,1200,630,1960,2
3,2.25,1520,3.0,0,1520,0,2004,2
4,2.5,2170,1.0,3,1350,820,1955,2
3,2.0,1200,1.0,0,880,320,1937,2
3,2.25,1580,1.0,0,1180,400,1992,2
3,1.75,1300,1.0,0,1300,0,1981,2
3,1.75,1560,1.0,0,1250,310,1983,2
4,2.5,2520,2.0,0,2520,0,1990,2
3,1.75,1600,1.0,0,1050,550,1977,2
4,2.5,1850,1.0,0,1230,620,1930,2
3,2.25,1780,1.0,2,1340,440,1972,2
4,1.75,2160,1.0,0,1260,900,1942,2
4,1.75,2120,1.0,0,1060,1060,1956,2
3,2.0,1890,2.0,0,1430,460,2012,2
4,2.5,2000,2.0,0,2000,0,2003,2
3,2.5,2150,2.0,0,2150,0,1992,2
3,1.75,1800,1.0,0,900,900,1905,2
3,2.25,2110,2.0,0,2110,0,1978,2
3,2.25,1470,2.0,0,1080,390,1984,2
4,2.5,1540,2.0,0,1540,0,2014,2
4,2.5,1830,1.0,0,1540,290,1973,2
3,2.0,2950,2.0,0,2310,640,1918,2
3,2.25,1630,2.0,0,1630,0,2005,2
6,2.5,2890,1.0,0,1630,1260,1977,3
5,3.25,2910,2.0,0,2040,870,2013,3
3,1.75,1840,1.0,0,1840,0,1964,3
3,2.5,1900,2.0,0,1900,0,1988,3
3,2.5,1960,2.0,0,1960,0,1989,3
4,2.5,2300,2.0,0,2300,0,1990,3
3,2.25,1300,2.0,0,1000,300,2006,3
4,2.0,1730,1.0,0,1060,670,1924,3
3,2.5,2060,1.0,0,1330,730,1976,3
3,2.5,1640,3.0,0,1640,0,2009,3
4,2.5,3220,1.5,0,3220,0,1966,3
3,2.5,2260,2.0,0,2260,0,1987,3
6,2.75,2660,1.0,0,1550,1110,1962,3
5,2.0,2130,1.5,0,1270,860,1926,3
4,3.5,2960,2.0,0,2960,0,2014,3
3,2.5,1500,2.0,0,1200,300,2014,3
4,2.5,2400,2.0,0,2400,0,1990,3
3,3.25,1980,3.0,0,1980,0,1987,3
5,3.0,3190,1.0,2,1890,1300,2013,3
3,2.5,3310,2.0,2,2440,870,2008,3
4,2.5,2810,2.0,0,2810,0,1982,3
4,2.5,2650,1.0,0,1680,970,1960,4
4,2.5,3420,2.0,0,3420,0,1988,4
4,2.25,2270,1.0,0,1340,930,1954,4
4,2.5,2300,2.0,0,2300,0,1999,4
4,3.5,3910,2.0,0,2490,1420,1987,4
4,3.0,3520,1.0,0,1980,1540,1954,4
3,2.25,2380,1.0,0,1450,930,1972,4
5,2.5,4470,2.5,0,4470,0,1984,4
4,2.5,3030,2.0,0,3030,0,1998,4
4,3.25,3440,2.0,0,3440,0,2006,4
5,3.5,3500,2.0,0,2570,930,1996,4
4,2.5,3160,2.0,0,3160,0,1965,4
4,3.75,3520,1.5,0,2200,1320,1913,4
4,2.5,4570,2.0,4,4570,0,1948,4
2,1.0,690,1.0,0,690,0,1942,1
3,1.5,1010,1.0,0,1010,0,1962,1
3,1.0,1000,1.0,0,1000,0,1991,1
3,1.0,1050,1.0,0,1050,0,1983,1
3,1.0,1410,1.0,0,1410,0,1951,1
2,1.0,970,1.0,0,970,0,1956,1
3,1.5,1330,1.0,0,1330,0,1968,1
3,1.0,880,1.0,0,880,0,1945,1
3,1.75,1330,1.0,0,1330,0,1968,1
4,1.75,1850,1.0,0,1270,580,1944,1
4,2.75,2000,2.0,0,2000,0,1997,1
3,2.25,1670,1.0,0,1190,480,1977,1
2,2.0,1180,1.0,0,1180,0,1940,1
3,1.0,1490,1.0,0,1120,370,1969,1
3,1.0,990,1.0,0,990,0,1968,1
3,2.5,1970,2.0,0,1090,880,1988,1
2,1.0,650,1.0,0,650,0,1950,1
3,1.0,2150,1.0,0,2150,0,1954,2
2,1.0,750,1.0,0,750,0,1941,2
4,2.0,1310,1.0,0,1310,0,1953,2
4,2.25,2210,2.0,0,2210,0,1968,2
4,1.75,2700,1.0,0,1380,1320,1958,2
5,2.5,2360,1.0,0,1180,1180,1962,2
4,2.5,2510,1.0,0,1610,900,1978,2
3,1.5,1460,1.0,0,1460,0,1955,2
3,1.0,850,1.0,0,850,0,1948,2
3,1.75,2000,1.0,0,1300,700,1968,2
2,1.0,900,1.0,0,900,0,1956,2
3,1.0,1480,1.0,0,970,510,1963,2
4,2.0,2470,1.5,0,1970,500,1948,2
3,1.0,1100,1.0,0,720,380,1942,2
2,1.75,1210,1.0,0,1210,0,1982,2
4,1.75,1760,1.0,2,1180,580,1950,2
3,1.5,1360,1.0,0,1360,0,1966,2
4,2.5,2090,2.0,0,2090,0,1989,2
4,3.0,2560,2.0,0,2560,0,2004,2
2,1.0,740,1.0,0,740,0,1922,2
2,2.25,930,2.0,0,630,300,2007,2
3,1.75,1500,1.0,0,1500,0,1957,2
4,1.75,1450,1.0,0,1450,0,1960,2
2,1.75,1240,1.5,0,1240,0,1906,2
3,1.75,1840,1.0,0,1340,500,1977,2
3,1.0,1660,1.0,0,1160,500,1978,2
3,2.5,1740,2.0,0,1740,0,1992,2
3,2.25,1860,2.0,0,1860,0,1963,2
4,1.75,1250,1.0,0,1250,0,1959,2
3,2.5,1600,2.0,0,1600,0,2007,2
4,1.75,1540,1.0,0,770,770,1943,2
3,2.5,2590,1.0,0,2590,0,1976,2
3,2.5,2970,1.0,0,1510,1460,1967,2
3,2.0,1230,1.0,0,990,240,1984,2
3,2.5,3170,2.0,0,2360,810,1995,2
3,2.5,2280,2.0,0,2280,0,2011,2
3,1.75,1070,1.0,0,1070,0,1977,2
3,2.5,2140,2.0,0,2140,0,2005,2
3,2.5,1930,2.0,0,1930,0,1990,2
4,1.5,1600,1.5,0,1600,0,1946,2
4,2.5,1890,1.0,0,1290,600,1980,2
3,1.75,1520,1.0,0,790,730,1948,2
3,1.75,2000,1.0,2,1480,520,1957,2
4,2.5,2950,2.0,0,2950,0,2005,2
3,2.25,1430,2.0,0,980,450,1996,2
3,1.75,1150,1.0,0,1150,0,1959,2
3,2.5,1500,1.0,0,900,600,1920,2
3,2.0,1300,1.0,0,1300,0,1955,3
3,2.25,1420,3.0,0,1420,0,2006,3
3,1.75,2300,1.0,0,2300,0,1984,3
2,1.5,1580,1.0,2,1280,300,1941,3
3,2.5,2070,2.0,0,2070,0,1999,3
5,2.75,3831,2.0,4,3831,0,1959,3
2,1.0,2034,1.0,4,1159,875,1947,3
4,2.5,4620,2.0,0,4620,0,1991,3
3,2.25,2400,1.5,0,1440,960,1926,3
3,2.5,2270,2.0,0,2270,0,1998,3
4,2.5,3190,2.0,0,3190,0,2006,3
5,2.75,2730,1.0,0,2080,650,1968,3
4,3.25,4690,2.0,2,3680,1010,1995,3
4,1.75,1740,1.0,0,1740,0,1968,3
3,1.75,1720,1.0,0,960,760,1924,3
4,2.5,2450,2.0,0,2450,0,1994,3
3,2.5,2410,1.0,0,1820,590,1976,3
4,2.5,2050,2.0,0,2050,0,2012,3
4,2.5,2341,2.0,0,2341,0,1997,3
2,2.25,2550,2.0,0,1860,690,1902,3
6,2.75,2840,1.0,0,1420,1420,1961,3
4,2.25,2420,2.0,0,2420,0,1973,3
3,3.5,2300,1.0,0,2300,0,2004,3
3,1.5,1820,1.5,0,1640,180,1946,3
4,1.75,2330,1.5,0,1510,820,1929,3
3,1.75,2200,1.0,0,1500,700,1978,3
4,2.5,2650,2.0,0,2650,0,1986,4
4,2.5,2440,2.0,0,2440,0,2013,4
4,3.25,3090,2.0,0,2370,720,2004,4
4,2.75,2610,1.0,0,1760,850,1978,4
4,3.5,3190,2.0,0,3190,0,2010,4
3,3.5,2130,2.0,2,1530,600,1908,4
3,2.5,3200,1.0,0,3200,0,2000,4
3,2.0,2540,1.5,0,1840,700,1930,4
4,3.5,3920,2.0,0,3920,0,1996,4
4,3.0,3330,1.0,0,1790,1540,1958,4
4,2.25,3550,1.0,0,1830,1720,2010,4
4,2.5,3220,2.0,0,3220,0,1996,4
4,2.5,3030,3.0,0,3030,0,2005,4
4,3.0,3580,1.5,0,3580,0,1985,4
3,2.25,3060,1.5,2,1810,1250,1930,4
4,3.75,3820,1.0,0,3820,0,1994,4
4,2.5,3220,1.0,0,1680,1540,1973,4
0,0.0,4810,2.0,0,4810,0,1990,4
5,4.75,6390,2.0,0,4560,1830,1940,4
2,1.0,890,1.0,0,890,0,1942,1
3,1.0,1090,1.0,0,1090,0,1969,1
1,0.75,930,1.0,0,930,0,1941,1
2,1.0,1120,1.0,0,1120,0,1944,1
3,1.0,1320,1.0,0,1320,0,1966,1
3,2.0,1190,1.0,0,1190,0,1995,1
3,1.0,1150,1.5,0,1150,0,1938,1
3,1.0,1050,1.0,0,1050,0,1958,1
3,1.0,1230,1.0,0,1230,0,1965,1
3,2.75,2210,2.0,0,2210,0,2008,1
3,1.0,1250,1.5,0,1250,0,1955,1
4,2.0,1570,2.0,0,1570,0,1984,1
3,2.25,1481,2.0,0,1481,0,2012,1
3,2.0,1410,1.0,0,1410,0,1985,1
3,2.25,1640,1.0,0,1180,460,1968,1
3,2.5,1620,2.0,0,1620,0,1989,1
4,2.25,1830,2.0,0,1830,0,1990,1
3,2.5,1720,2.0,0,1720,0,1992,1
5,2.5,2025,2.0,0,2025,0,2007,1
3,1.5,1580,1.0,0,1140,440,1954,1
3,1.5,1150,1.0,0,1150,0,1951,1
2,1.0,2060,1.0,0,1260,800,1962,1
3,2.5,1670,1.0,0,1300,370,1990,1
2,1.0,770,1.0,0,770,0,1927,1
4,2.25,2460,1.0,0,2460,0,1959,1
3,1.0,1270,1.0,0,1270,0,1958,1
7,2.5,1940,2.0,0,1940,0,1994,1
3,1.75,1230,1.0,0,1230,0,1966,1
3,1.0,890,1.0,0,890,0,1954,1
3,2.0,1460,1.0,0,1460,0,1995,1
2,1.0,780,1.0,0,780,0,1930,1
3,1.0,1110,1.0,0,1110,0,1979,1
3,2.5,1870,2.0,0,1870,0,1990,1
3,1.75,1790,1.0,3,1790,0,1978,1
6,2.0,1900,1.0,0,1200,700,1964,2
3,1.0,1640,1.5,0,1640,0,1942,2
3,2.5,1860,2.0,0,1860,0,2012,2
2,1.0,870,1.0,0,870,0,1950,2
4,2.0,1780,1.5,0,930,850,1918,2
4,2.5,2000,2.0,0,2000,0,1997,2
3,2.5,1730,2.0,0,1730,0,2014,2
2,1.75,1610,1.0,0,1010,600,1941,2
3,1.0,1150,1.0,0,1150,0,1932,2
3,1.0,1010,1.0,0,1010,0,1947,2
4,1.0,1530,1.0,0,980,550,1925,2
4,2.0,2020,1.5,0,2020,0,1949,2
3,2.5,1150,3.0,0,1150,0,2007,2
3,2.5,1800,2.0,0,1800,0,2011,2
3,2.0,1410,1.0,0,1410,0,1983,2
3,2.25,1400,2.0,0,1400,0,1984,2
5,3.25,3370,2.0,0,3370,0,2001,2
3,1.75,1500,1.0,0,1500,0,1977,2
4,2.25,2050,2.0,2,1770,280,1965,2
4,2.5,2340,2.0,0,2340,0,1993,2
2,2.25,1350,2.0,0,1050,300,2007,2
3,2.5,2180,1.0,0,1420,760,1962,2
4,2.25,2000,2.0,0,1650,350,1926,2
2,2.5,1590,2.0,0,1590,0,1997,2
3,1.5,1250,1.0,0,1250,0,1968,2
4,2.25,2100,1.0,0,1290,810,1973,2
3,2.5,2320,3.0,0,2320,0,2009,2
2,1.0,1060,1.5,0,1060,0,1943,2
3,1.75,2030,1.0,0,2030,0,1953,2
3,1.5,2330,1.0,0,1330,1000,1954,2
4,2.75,2310,1.0,2,1330,980,1952,2
2,1.0,1380,1.0,0,880,500,1931,2
3,1.0,1970,1.0,0,1970,0,1970,2
3,2.5,2420,2.0,0,2420,0,1998,2
3,1.75,1640,1.0,2,1640,0,1975,3
3,2.5,1860,2.0,0,1860,0,1987,3
4,2.5,1950,1.5,0,1250,700,1910,3
5,2.25,2140,1.0,0,1070,1070,1962,3
4,2.75,3110,1.0,0,3110,0,1958,3
4,2.5,2030,2.0,0,2030,0,1994,3
3,1.75,1900,1.0,0,1900,0,1959,3
2,0.75,1440,1.0,0,1200,240,1914,3
3,2.5,1400,3.5,0,1400,0,2007,3
2,1.75,1670,1.0,0,1670,0,2005,3
3,2.5,2380,2.0,0,2380,0,2002,3
3,2.25,1700,1.5,0,1100,600,1924,3
4,2.5,2070,2.0,0,2070,0,1996,3
3,2.5,1790,2.0,0,1790,0,1989,3
4,2.75,2890,1.0,0,1560,1330,1973,3
5,3.0,2790,1.0,3,1500,1290,1973,3
4,2.75,2720,2.0,0,2720,0,2005,3
3,1.75,1870,1.0,0,1870,0,1958,3
4,4.0,3570,2.0,0,2860,710,2013,3
3,2.25,2680,1.0,0,1570,1110,1978,3
4,2.5,2690,2.0,0,2690,0,2001,3
5,2.5,2700,1.0,0,1950,750,1955,3
3,1.75,1620,1.0,0,1040,580,1947,3
3,2.75,1850,1.0,2,1850,0,1953,3
4,2.75,1910,1.0,0,1420,490,1940,3
4,2.5,2180,1.5,0,1420,760,1926,3
4,1.5,1880,1.0,2,1440,440,1954,3
5,2.0,2000,1.5,2,1280,720,1908,3
4,2.5,2770,2.0,0,2770,0,2004,3
3,2.5,2610,2.0,0,2610,0,1996,4
4,2.5,2490,2.0,0,2490,0,2000,4
5,2.5,2980,2.0,0,2980,0,2006,4
4,2.5,3000,2.0,0,3000,0,1995,4
5,2.5,2700,1.0,0,1750,950,1967,4
4,2.5,2760,2.0,0,2230,530,1942,4
4,3.5,4000,2.0,0,4000,0,2007,4
4,2.5,3920,2.0,0,3920,0,1997,4
4,2.5,3070,2.0,0,3070,0,2005,4
5,3.25,4500,2.0,4,3000,1500,1968,4
4,2.75,2840,1.5,0,1960,880,1912,4
4,1.0,2550,2.0,0,2370,180,1905,4
5,3.5,3100,1.0,4,1660,1440,1970,4
5,2.25,2370,2.0,0,2370,0,1981,4
5,3.25,3160,2.0,2,2180,980,2005,4
5,3.0,2620,2.0,0,2620,0,2009,4
3,4.5,4380,2.0,3,3720,660,1968,4
4,2.25,3310,2.0,0,3310,0,1924,4
4,1.75,3990,2.0,0,3990,0,2006,4
4,3.5,3770,2.0,0,2830,940,1989,4
4,3.5,4660,2.0,2,4660,0,2003,4
5,3.5,5850,2.0,2,4670,1180,1978,4
3,1.0,1310,1.0,0,960,350,1962,1
3,1.5,1220,1.0,0,1220,0,1968,1
3,1.75,1260,1.0,0,1260,0,1963,1
2,1.0,920,1.0,0,920,0,1950,1
2,1.0,720,1.0,0,720,0,1943,1
3,1.5,1090,1.0,0,1090,0,1967,1
2,1.75,1390,1.0,0,1390,0,1980,1
3,1.0,1090,1.5,0,1090,0,1912,1
3,1.5,1660,2.0,0,1660,0,1981,1
4,1.5,1600,1.0,0,1600,0,1959,1
3,1.75,1500,1.0,0,1500,0,2014,1
3,2.0,1700,1.0,0,970,730,1945,1
2,1.75,1590,1.0,0,1590,0,1972,1
3,1.0,1060,1.0,0,1060,0,1956,1
4,2.0,1330,1.0,0,1330,0,1942,1
4,1.0,1200,1.5,0,1200,0,1933,1
3,1.0,1140,1.0,0,1140,0,1981,1
3,1.0,1750,1.0,0,1150,600,1956,1
3,2.0,1900,1.0,0,1900,0,1991,1
4,1.0,1230,1.5,0,1230,0,1944,1
3,1.0,1640,1.0,0,1090,550,1954,1
5,2.0,2080,1.0,0,1740,340,1959,1
3,2.0,1470,1.0,0,1470,0,1968,1
2,1.0,930,1.0,0,930,0,1924,1
3,2.5,1630,1.0,0,1120,510,1978,1
3,2.5,1650,2.0,0,1650,0,1991,1
4,2.25,2600,1.0,0,1600,1000,1965,1
3,1.75,1580,1.0,0,1580,0,1988,1
4,2.25,2070,2.0,0,2070,0,1977,1
2,1.0,1010,1.0,0,1010,0,1975,1
4,2.25,2260,2.0,0,2260,0,1984,1
3,1.75,1570,1.0,0,1080,490,1956,1
3,2.25,1780,1.0,0,1780,0,1967,2
4,1.75,1530,1.5,0,1530,0,1968,2
4,2.5,2430,2.0,0,2430,0,2002,2
4,2.5,1940,1.0,0,1140,800,1977,2
3,2.0,1550,1.5,0,1550,0,1999,2
2,1.0,950,1.0,2,950,0,1948,2
4,3.0,1930,1.0,0,1200,730,2006,2
3,2.5,1769,2.0,0,1769,0,2012,2
2,1.0,950,1.0,0,950,0,1941,2
3,2.25,1780,2.0,0,1780,0,1987,2
4,2.5,2580,2.0,0,2580,0,2005,2
4,2.75,2530,1.0,0,1280,1250,1977,2
3,1.5,1400,1.0,0,1400,0,1952,2
3,1.5,2450,1.0,0,2450,0,1967,2
5,1.75,1940,1.5,0,1940,0,1953,2
5,2.0,2280,1.5,0,2280,0,1924,2
3,1.5,2380,1.0,0,1850,530,1961,2
4,2.5,3200,1.0,0,1610,1590,1970,2
3,3.25,1370,2.0,0,1100,270,2006,2
4,3.0,3060,2.0,0,3060,0,2001,2
4,2.5,2220,2.0,0,2220,0,2001,2
4,2.75,4230,2.0,0,4230,0,1985,2
3,2.5,2490,2.5,0,2490,0,2012,2
3,1.0,1170,1.0,0,1170,0,1957,2
3,2.5,2370,2.0,0,2370,0,2009,2
4,2.75,2110,1.0,0,1510,600,1962,2
4,2.5,2250,2.0,0,2250,0,1989,2
3,1.5,2120,1.0,0,1220,900,1949,2
4,2.5,2160,1.0,0,1390,770,1976,2
4,1.5,1770,2.0,0,1770,0,1947,2
2,1.5,1370,2.0,0,1080,290,2008,2
3,1.5,1530,1.0,0,1530,0,1952,2
5,2.75,2830,1.5,0,2830,0,1967,2
4,2.5,2550,1.0,0,1300,1250,1961,2
3,2.5,1730,1.0,0,1210,520,1969,2
2,1.75,1240,1.0,0,1240,0,1924,2
3,1.75,1520,1.0,0,1520,0,1983,2
3,1.75,1440,1.0,0,1440,0,1983,2
3,3.5,1590,3.0,0,1590,0,2010,3
4,2.75,3030,2.0,0,3030,0,2011,3
3,2.0,2330,2.5,0,2330,0,1987,3
3,3.0,2410,2.0,2,2410,0,1942,3
5,3.0,3640,2.0,0,3640,0,2004,3
4,2.5,2480,1.0,0,1510,970,1959,3
5,3.0,3690,1.0,2,2690,1000,1960,3
4,1.75,1720,1.0,0,1420,300,1975,3
3,2.5,3240,2.0,0,2910,330,2004,3
4,2.5,2770,2.0,0,2770,0,1989,3
6,3.5,3600,2.0,0,2740,860,2004,3
3,2.0,2460,1.0,0,2460,0,1988,3
3,1.75,2430,2.0,0,1760,670,1945,3
3,2.0,1660,1.0,0,970,690,1922,3
3,2.5,2480,1.5,3,2480,0,1974,3
2,1.75,1950,1.0,3,1160,790,1952,3
4,2.5,2670,2.0,0,2670,0,1996,3
4,2.5,2150,2.0,0,2150,0,1997,3
5,3.5,2720,2.0,0,1860,860,1993,3
3,2.75,2590,2.0,0,2590,0,1993,3
3,3.25,3740,2.5,0,3100,640,1990,4
6,3.0,3110,1.5,0,1810,1300,1921,4
4,2.75,2880,1.5,0,2100,780,1912,4
3,2.5,1980,1.0,0,1980,0,1959,4
4,2.5,2660,1.0,0,2660,0,1955,4
3,2.75,2850,1.0,0,1920,930,1976,4
4,3.25,3060,2.0,0,2300,760,2014,4
3,1.75,2080,1.0,0,2080,0,1958,4
4,2.5,2990,2.0,0,2990,0,1990,4
3,2.75,2600,1.5,2,1600,1000,1929,4
4,2.75,2620,1.0,2,1310,1310,1949,4
3,2.0,2270,1.0,0,2270,0,1968,4
4,2.5,3060,2.0,0,3060,0,2006,4
4,2.5,3230,1.0,0,1870,1360,1977,4
4,3.5,3370,2.0,2,2470,900,2008,4
4,3.5,4040,2.0,0,4040,0,1987,4
4,3.75,3460,2.0,0,3460,0,2013,4
4,3.5,3320,1.0,2,2040,1280,1977,4
4,3.5,3450,2.0,0,3450,0,2007,4
4,3.5,3990,2.0,0,3990,0,2008,4
3,3.0,3760,2.5,3,3060,700,1910,4
4,3.0,4040,1.0,0,2020,2020,1972,4
4,2.25,3250,2.0,0,3250,0,1979,4
3,1.0,1060,1.0,0,1060,0,1959,1
1,1.0,690,1.0,0,690,0,1928,1
2,1.0,900,1.0,0,900,0,1905,1
2,1.0,1020,1.0,0,1020,0,1940,1
3,1.0,970,1.0,0,970,0,1967,1
2,1.0,940,1.0,0,940,0,1926,1
2,1.75,1220,1.0,0,1220,0,1972,1
3,1.0,910,1.0,0,910,0,1966,1
2,1.75,1110,2.0,0,1110,0,2014,1
3,1.75,1010,1.0,0,1010,0,1969,1
4,1.0,1390,1.0,0,1390,0,1955,1
3,1.75,1950,1.0,0,1950,0,1960,1
3,1.75,1400,1.0,0,1400,0,1998,1
1,1.5,1170,2.0,0,1070,100,2007,1
3,3.0,1670,1.0,0,1670,0,2014,1
3,2.5,1720,2.0,0,1720,0,1998,1
3,2.25,1715,2.0,0,1715,0,1995,1
3,1.75,1650,1.0,0,1650,0,1957,1
2,1.0,700,1.0,0,700,0,1922,1
2,1.0,720,1.0,0,720,0,1951,1
3,2.5,1630,1.0,0,1320,310,1985,1
2,1.0,910,1.0,0,910,0,1948,1
4,2.0,1350,3.0,0,1350,0,2008,1
3,1.5,1590,1.0,0,1590,0,1956,2
6,4.0,3120,2.0,2,2090,1030,1993,2
4,2.5,2570,2.0,0,2570,0,2005,2
5,2.75,2400,2.0,0,2400,0,1998,2
4,1.75,2440,1.0,0,1610,830,1978,2
3,1.75,1780,1.0,0,1280,500,1981,2
5,1.75,2330,1.0,0,1180,1150,1968,2
3,1.75,2040,1.0,0,2040,0,1980,2
4,2.5,1890,2.0,0,1890,0,1996,2
2,2.25,1330,2.0,0,1330,0,1985,2
4,2.5,3000,2.0,0,3000,0,2002,2
5,1.0,1170,1.0,0,800,370,1944,2
3,2.5,2570,2.0,0,2570,0,1989,2
3,2.0,1400,2.0,0,1400,0,1981,2
3,1.0,2710,2.0,3,2710,0,1950,2
3,1.75,2410,1.0,0,1860,550,1967,2
4,2.25,2300,1.0,0,1380,920,1959,2
3,2.5,2432,2.0,2,2432,0,2005,2
2,1.0,1050,1.0,0,850,200,1927,2
2,1.0,1320,1.0,0,1320,0,1953,2
4,2.75,2300,1.0,3,1550,750,1979,2
4,3.0,2530,2.0,0,2530,0,2013,2
4,2.5,2110,1.0,0,1290,820,1985,2
4,2.25,2020,1.0,0,1380,640,1979,2
4,2.5,3060,2.0,0,3060,0,2012,2
4,2.5,2990,2.0,0,2990,0,1991,2
4,3.0,2370,1.5,0,1650,720,1916,2
2,1.0,1500,1.0,0,1500,0,1902,2
4,2.75,2790,2.0,0,2790,0,2014,2
3,2.5,2230,2.0,0,2230,0,2000,2
4,1.0,1440,1.5,0,1440,0,1906,3
2,1.5,1200,3.0,0,1200,0,2008,3
5,1.75,1890,1.5,0,1090,800,1906,3
4,1.75,2860,1.0,0,1710,1150,1978,3
4,3.5,4150,2.0,0,4150,0,2006,3
4,2.5,2710,2.0,0,2710,0,2003,3
3,1.75,1960,1.0,0,980,980,1939,3
3,3.25,2310,2.0,0,1730,580,2005,3
4,1.75,2420,1.0,0,1880,540,1981,3
4,2.5,2770,2.0,0,2770,0,1997,3
5,2.5,2500,1.0,0,1490,1010,1977,3
3,2.5,2610,2.0,0,2610,0,1988,3
3,2.25,2400,1.5,0,1250,1150,1939,3
4,2.5,2540,2.0,0,2540,0,1987,3
4,2.75,3190,2.0,0,3190,0,1994,3
3,2.5,1660,2.0,2,1400,260,2002,4
3,2.5,2440,2.0,0,2440,0,2003,4
3,2.5,3580,1.5,0,3580,0,1990,4
3,3.0,2630,2.0,0,2630,0,2006,4
4,2.25,3190,2.0,0,2300,890,1984,4
5,2.5,3260,1.5,1,2310,950,1950,4
4,2.75,3610,2.0,0,3610,0,2014,4
4,4.25,4390,2.0,3,3320,1070,2003,4
5,2.75,3650,2.0,0,2750,900,1969,4
4,3.0,3900,1.0,4,2520,1380,1972,4
4,4.5,6640,2.0,0,6640,0,1993,4
2,1.75,1910,2.0,0,1910,0,1980,1
3,1.0,1040,1.0,0,1040,0,1983,1
4,1.0,1370,1.0,0,1370,0,1949,2
3,1.75,1700,1.0,0,1200,500,1978,2
3,1.0,1200,1.0,0,1200,0,1969,2
3,1.5,1500,1.5,0,1140,360,1927,2
3,2.5,1700,1.0,0,1160,540,1998,2
5,2.5,2670,1.5,0,1620,1050,1920,3
4,2.5,3130,2.0,0,3130,0,1994,3
4,2.5,2190,1.0,0,1430,760,1972,3
3,1.0,1800,1.0,0,1800,0,1957,1
5,2.75,2130,1.0,0,1300,830,1991,2
3,2.0,1610,1.0,0,1610,0,1986,2
3,3.5,1360,2.0,0,1240,120,2007,2
4,2.75,2950,1.0,0,2120,830,1974,2
3,2.25,2120,2.0,0,2120,0,1964,4
2,1.0,930,1.0,0,930,0,1942,1
2,1.0,1200,2.0,0,1200,0,1976,1
2,1.0,900,1.0,0,900,0,1928,1
2,1.5,1068,2.0,0,1068,0,1990,1
3,2.75,1300,1.0,0,860,440,1996,1
3,2.0,1440,1.0,0,1440,0,1965,1
2,1.0,1320,1.0,0,940,380,1919,1
3,1.75,1410,2.0,0,1410,0,1985,1
2,2.0,1860,1.0,0,1260,600,1952,1
3,2.5,1760,1.5,0,1760,0,1937,1
2,1.0,960,1.0,0,960,0,1947,2
3,1.0,1010,1.0,0,1010,0,1954,2
3,2.25,2310,2.0,0,2310,0,1990,2
4,2.5,2340,2.0,0,2340,0,1997,2
4,2.5,2230,2.0,0,2230,0,2002,2
4,2.5,2280,2.0,0,2280,0,2006,2
2,1.0,970,1.0,0,970,0,1932,2
3,1.0,960,1.0,0,960,0,1958,2
4,2.75,2140,2.0,0,2140,0,1993,2
3,1.0,1320,1.0,0,1320,0,1982,2
4,2.5,2700,2.0,0,2700,0,2001,2
3,1.75,1300,1.0,0,1300,0,1968,2
4,2.5,2570,2.0,0,2570,0,1992,2
2,1.0,870,1.0,0,870,0,1947,2
5,3.25,2820,1.5,0,2320,500,1906,2
2,1.75,1510,1.0,0,1510,0,2006,2
2,2.0,1090,3.0,0,1090,0,2008,2
3,2.25,1370,3.0,0,1370,0,2005,2
4,2.0,1880,1.0,0,970,910,1904,2
4,2.5,2290,2.0,0,2290,0,1988,2
3,2.5,3180,1.0,0,1810,1370,2006,2
4,2.25,2070,1.0,0,1470,600,1977,2
4,2.5,2960,2.0,0,2960,0,2005,2
3,2.5,1220,2.0,0,1010,210,2008,2
3,1.75,3600,2.0,0,2400,1200,1948,2
4,3.0,2440,2.0,0,1890,550,1981,2
4,3.0,2330,2.0,0,1920,410,2003,2
3,2.25,1470,2.0,0,1470,0,1985,2
3,2.25,2090,1.0,0,1440,650,1958,2
4,1.75,2120,1.0,0,1640,480,1967,2
4,3.0,3720,3.0,0,3720,0,1979,3
3,2.5,2600,2.0,0,2600,0,2003,3
4,2.25,1980,2.0,0,1980,0,1981,3
3,1.0,1580,1.0,0,1180,400,1925,3
5,2.75,2520,1.0,3,1570,950,1960,3
3,2.5,1460,2.0,0,1180,280,2007,3
4,1.5,2750,1.0,0,1500,1250,1958,3
3,2.25,1720,1.0,0,1220,500,1967,3
3,2.25,2070,1.5,0,2070,0,1955,3
3,2.0,1890,1.0,0,1470,420,1949,3
3,2.5,3350,2.0,0,2550,800,2005,3
4,2.25,2500,1.5,0,1520,980,1940,3
5,3.0,2870,1.0,0,1950,920,1964,4
4,2.5,3500,2.0,0,3500,0,2005,4
3,2.5,2650,2.0,0,1830,820,1920,4
4,2.75,3220,1.5,0,2320,900,1931,4
4,2.5,3560,3.0,0,3560,0,2014,4
4,2.5,3670,2.5,0,3670,0,2007,4
4,3.25,3530,2.0,0,3530,0,2007,4
4,2.75,3330,2.0,0,3330,0,1995,4
3,3.0,3790,2.0,0,2810,980,1989,4
5,3.25,4390,2.0,0,4390,0,2007,4
5,3.5,5000,2.0,3,3410,1590,2008,4
5,4.25,4830,2.5,2,3710,1120,1914,4
2,1.0,820,1.0,0,820,0,1937,1
3,1.0,1200,1.0,0,1200,0,1959,1
2,1.0,900,1.0,0,900,0,1979,1
1,1.0,590,1.0,0,590,0,1926,1
3,1.75,1170,1.0,0,1170,0,1981,1
3,1.75,1400,1.0,0,1400,0,1984,1
3,1.5,1620,1.0,0,1620,0,1967,1
3,2.0,1770,1.0,0,1770,0,1986,1
3,2.0,1190,1.5,0,1190,0,1907,1
3,1.0,950,1.0,0,950,0,1954,1
3,2.25,1920,1.0,0,1300,620,1961,1
2,1.0,770,1.0,0,770,0,1948,1
4,2.5,1970,2.0,0,1970,0,1987,1
3,1.0,1090,1.0,0,1090,0,1962,1
4,2.5,2303,2.0,0,2303,0,2006,2
3,2.75,2090,1.0,0,1340,750,1987,2
3,2.25,1660,2.0,0,1660,0,2001,2
3,1.0,1150,1.5,0,1150,0,1927,2
3,2.0,2050,1.0,0,2050,0,1993,2
4,2.5,1830,2.0,0,1830,0,2003,2
4,1.75,2550,1.0,0,1300,1250,1978,2
3,2.5,1680,1.0,0,1080,600,1959,2
2,2.5,1050,2.0,0,950,100,2007,2
3,2.25,1460,3.0,0,1460,0,2006,2
2,1.0,1080,1.0,0,1080,0,1955,2
3,2.0,1270,1.0,0,1270,0,1963,2
3,3.5,2080,2.0,0,2080,0,2004,2
4,2.5,2590,2.0,0,2590,0,1991,2
2,1.0,860,1.0,0,860,0,1952,2
3,1.75,2530,1.0,0,1800,730,1977,2
3,1.75,1040,1.0,0,1040,0,1967,2
5,2.25,3740,1.5,0,2240,1500,1958,2
4,2.5,2701,2.0,0,2701,0,2014,2
3,2.0,1240,1.0,0,1000,240,1984,2
4,1.0,1580,1.5,2,1580,0,1928,2
4,2.5,2530,2.0,0,2530,0,2014,2
3,1.5,1300,1.0,0,1300,0,1964,2
3,2.5,1950,2.0,0,1950,0,2009,2
4,2.5,2300,2.0,0,2300,0,2001,2
4,1.5,1550,1.0,0,1180,370,1963,2
3,2.5,2530,2.0,0,2530,0,1993,2
4,2.5,2280,2.0,0,2280,0,1994,2
3,1.75,1400,1.0,0,1400,0,1963,2
2,1.0,1250,1.0,0,850,400,1929,2
3,2.5,1450,2.0,0,940,510,2008,2
4,3.0,2890,1.0,0,1590,1300,1945,2
3,2.25,1640,2.0,0,1640,0,1994,2
3,2.25,1710,2.0,0,1710,0,1989,2
3,2.25,2440,2.0,0,2090,350,1991,2
4,1.75,1430,2.0,0,1430,0,1900,2
4,2.75,2910,2.0,0,2910,0,2013,2
5,3.25,3130,2.0,0,2180,950,1975,3
3,2.25,1600,2.0,0,1600,0,1983,3
4,2.75,2200,1.0,0,1100,1100,1962,3
3,1.75,1990,1.0,0,1190,800,1977,3
3,1.75,1750,2.0,0,1750,0,1934,3
3,2.5,2010,2.0,0,2010,0,1994,3
3,2.5,3660,2.0,2,3260,400,1989,3
4,1.75,1420,1.5,0,1420,0,1945,3
3,1.75,2050,1.0,0,1400,650,1984,3
4,2.5,2180,1.0,0,1180,1000,1968,3
4,2.5,2440,2.0,0,2440,0,1994,3
3,2.5,1530,1.5,0,1010,520,1928,3
4,1.0,1410,1.5,0,1410,0,1911,3
3,2.5,2200,2.0,2,2200,0,1978,3
4,1.0,1630,1.5,0,1630,0,1921,3
3,2.0,1410,1.0,0,910,500,1947,3
5,2.25,2980,1.0,0,1580,1400,1960,3
2,2.5,2510,2.0,0,2510,0,1990,3
4,1.75,1700,1.0,0,1700,0,1957,3
4,3.0,2130,1.0,0,1440,690,1948,3
3,2.5,2390,2.0,0,2220,170,2008,3
4,2.5,3350,2.0,0,3350,0,2004,3
3,2.0,2570,1.0,0,1970,600,1983,3
4,2.5,1820,2.0,0,1820,0,1987,3
4,2.5,2600,2.0,0,2600,0,1962,3
3,2.5,2620,2.0,0,2620,0,1998,3
3,2.0,2500,1.5,0,1680,820,1922,3
3,2.5,2375,2.0,0,2375,0,2002,4
3,1.75,1860,2.0,2,1860,0,1959,4
4,2.5,2840,1.0,0,1780,1060,1977,4
5,2.5,3290,2.0,0,3290,0,2004,4
4,2.25,2500,2.0,0,2500,0,1987,4
3,2.25,2880,2.0,0,2880,0,1989,4
4,2.75,3990,2.0,0,3990,0,2003,4
4,3.25,4350,1.0,0,2200,2150,2006,4
5,3.5,3840,2.0,0,3840,0,2001,4
4,3.5,4080,2.0,0,4080,0,2005,4
5,5.5,5190,2.0,2,5190,0,2001,4
4,1.5,2550,2.0,0,2550,0,1910,4
4,3.5,3770,2.0,0,3770,0,2008,4
4,2.5,4570,2.0,2,4570,0,1990,4
3,2.75,3890,2.0,1,3260,630,1967,4
5,3.25,3350,2.0,0,2510,840,1997,4
4,2.5,3340,2.0,0,3340,0,1996,4
4,3.5,3400,2.5,0,2790,610,2008,4
4,3.5,4270,2.0,3,3170,1100,1937,4
2,1.0,1050,1.5,0,1050,0,1964,1
4,2.5,1780,2.0,0,1780,0,1991,1
5,1.0,1590,1.5,0,1090,500,1942,1
3,2.0,1110,1.0,0,1110,0,1991,1
3,3.0,2470,2.0,0,1860,610,1977,1
3,2.25,1920,1.0,0,1520,400,1965,1
3,1.75,1200,1.0,0,1200,0,1984,1
2,1.0,1310,1.0,0,940,370,1980,1
4,2.0,2430,1.0,0,1430,1000,1960,1
4,2.25,1680,2.0,0,1680,0,2002,1
4,2.5,2050,2.0,0,2050,0,2002,1
4,2.0,1620,2.0,0,1620,0,1975,1
5,1.0,1870,1.0,0,1580,290,1962,1
4,3.0,1940,1.0,0,1940,0,1948,1
2,1.5,800,2.0,0,800,0,2008,1
4,2.5,1954,2.0,0,1954,0,2005,1
3,2.25,1450,2.0,0,1450,0,2010,1
3,2.25,1520,2.0,0,1520,0,1992,1
2,1.0,1010,1.0,0,1010,0,1947,2
2,1.0,2160,1.0,0,1360,800,1968,2
3,1.0,1580,1.0,0,1010,570,1962,2
3,2.5,2242,2.0,0,2242,0,2014,2
2,1.0,700,1.0,0,700,0,1918,2
2,1.75,1530,1.0,1,830,700,1916,2
4,2.5,2120,2.0,0,2120,0,2002,2
4,2.5,2105,2.0,0,2105,0,2003,2
3,2.5,2390,1.0,0,1840,550,1984,2
5,2.5,2450,2.0,0,2450,0,2002,2
3,1.75,1730,1.5,0,1730,0,1954,2
4,1.75,2400,1.5,0,1500,900,1927,2
4,2.5,3002,2.0,0,3002,0,2004,2
3,2.5,1900,2.0,0,1900,0,1993,2
3,2.0,1660,1.0,0,1260,400,1983,2
4,2.75,2620,2.0,0,2620,0,2013,2
4,2.0,2100,1.0,0,1050,1050,1962,2
4,2.5,2040,2.0,0,2040,0,1963,2
4,2.5,1850,2.0,0,1850,0,1981,2
5,2.5,2160,2.0,0,2160,0,1998,2
3,2.0,1470,1.0,0,1470,0,1956,2
3,2.25,1550,2.0,0,1550,0,1987,2
4,2.5,1540,2.0,0,1540,0,2014,2
3,3.0,3700,2.0,0,3700,0,1982,2
3,1.75,1540,1.0,2,770,770,1920,3
5,2.25,2570,1.0,1,1470,1100,1950,3
3,1.75,2330,1.0,0,1390,940,1983,3
4,2.75,2160,1.0,0,1430,730,1987,3
4,2.0,1660,1.5,0,1660,0,1922,3
3,2.5,1840,1.0,0,1840,0,1978,3
3,2.5,2280,2.0,0,1880,400,2006,3
3,1.75,2680,1.0,0,1590,1090,1974,3
3,2.25,1900,1.5,0,1200,700,1905,3
3,1.75,1490,2.0,0,1090,400,2008,3
4,3.5,2500,2.0,0,1810,690,2008,3
5,2.0,2190,1.0,0,1110,1080,1965,3
4,2.25,2940,1.0,0,1520,1420,1961,3
3,2.25,2080,1.0,0,1530,550,1973,3
3,3.0,1820,3.0,0,1540,280,2006,3
4,2.5,2190,1.0,0,1410,780,1979,3
3,1.75,2270,1.0,0,1370,900,1956,3
4,2.0,2090,1.0,0,2090,0,1951,3
5,2.5,2950,1.5,0,1720,1230,1918,3
5,2.25,2900,1.0,0,1450,1450,1985,3
3,1.5,1760,2.0,0,1760,0,1922,3
3,2.5,2490,2.0,0,2490,0,1993,3
4,3.0,3550,1.5,0,2180,1370,1990,4
4,2.25,2430,1.5,0,1630,800,1928,4
3,3.75,2670,2.5,4,2020,650,1977,4
4,2.5,2890,2.0,0,2890,0,2005,4
5,3.25,3760,2.0,0,2550,1210,1984,4
4,1.75,1880,1.5,0,1880,0,1924,4
3,4.5,3850,2.0,0,3120,730,2013,4
4,3.5,3390,2.0,0,2610,780,2014,4
3,2.5,3280,1.0,0,1680,1600,1970,4
6,4.5,3830,3.0,0,3050,780,1919,4
3,3.5,4660,2.0,4,3040,1620,1909,4
2,0.75,660,1.0,0,660,0,1912,1
4,1.75,2080,1.0,0,1050,1030,1966,1
4,1.0,1200,1.5,0,1200,0,1923,1
3,1.75,1570,1.0,0,1570,0,1960,1
3,1.75,1770,1.0,0,1770,0,1959,1
2,1.5,920,2.0,0,920,0,1995,1
4,2.25,2060,1.0,0,1200,860,1962,1
3,1.0,1020,1.0,0,1020,0,1959,1
3,1.0,1740,1.0,0,1020,720,1962,1
4,2.5,1890,2.0,0,1890,0,1997,1
5,2.5,2270,2.0,0,2270,0,1995,1
2,1.0,870,1.0,0,870,0,1942,1
3,2.5,1520,2.0,0,1520,0,2004,1
3,1.0,1440,1.0,0,1440,0,1967,1
2,1.0,1190,1.0,0,1190,0,1948,1
4,1.75,2600,1.0,0,1610,990,1969,2
3,1.75,1830,1.0,0,930,900,1950,2
8,2.75,2790,1.0,0,1470,1320,1977,2
3,1.0,1390,1.5,0,1390,0,1908,2
4,2.5,2300,2.0,0,2300,0,2001,2
4,2.5,2040,2.0,0,2040,0,1999,2
2,1.0,860,1.0,0,860,0,1956,2
4,2.75,2640,1.5,0,2640,0,1963,2
5,1.75,1840,1.0,2,1360,480,1948,2
2,1.75,1410,1.5,0,900,510,2011,2
4,2.25,2230,1.0,0,1300,930,1963,2
2,2.75,1350,2.0,0,1120,230,2006,2
4,2.5,1700,1.0,0,1700,0,1972,2
3,1.5,1400,3.0,0,1400,0,2007,2
3,1.5,1810,1.0,0,1030,780,1958,2
3,2.5,1930,2.0,0,1300,630,2005,2
3,2.5,2250,2.0,0,2250,0,2000,2
3,1.75,1530,2.0,0,1530,0,1978,2
3,2.5,3316,2.0,0,3316,0,1986,2
2,1.5,1930,2.0,0,1930,0,1989,3
5,3.25,2740,1.0,0,1390,1350,1977,3
4,3.0,2590,2.0,0,2590,0,2014,3
4,2.5,2020,2.0,0,1730,290,1943,3
3,2.5,2950,2.0,0,2950,0,2006,3
4,2.5,2230,1.0,0,1430,800,1969,3
3,1.75,1530,1.0,0,1410,120,1955,3
5,3.0,2190,2.0,0,1490,700,1940,3
5,2.25,3000,2.0,0,3000,0,1975,3
4,2.5,2800,1.0,0,1420,1380,1970,3
3,2.5,2610,2.0,0,2610,0,2001,3
3,2.0,2300,1.0,0,1430,870,1955,3
4,2.5,2360,1.0,3,1980,380,1977,3
3,2.25,1980,1.0,0,1980,0,1959,3
3,4.0,2080,3.0,4,2080,0,1997,4
4,2.5,3150,2.0,0,3150,0,2002,4
4,4.25,4930,2.0,0,4930,0,2005,4
3,2.5,3230,2.0,2,2430,800,1945,4
3,2.0,2470,2.0,0,2470,0,1961,4
4,2.0,2490,2.0,0,2490,0,1968,4
6,2.75,2520,2.0,4,2520,0,1954,4
4,2.5,2980,2.0,0,2980,0,1989,4
3,3.25,3620,2.0,0,2730,890,2005,4
4,3.5,4370,2.0,0,4370,0,2008,4
4,5.0,4110,2.0,0,4110,0,1978,4
4,3.75,5070,2.0,0,5070,0,2000,4
4,2.5,3160,2.0,0,3160,0,1995,4
3,2.5,2780,1.5,1,2110,670,1969,4
5,2.5,3580,2.0,0,3580,0,2000,4
5,3.0,3420,2.0,0,2540,880,1952,4
3,2.5,2320,2.0,0,2320,0,2003,3
3,1.75,1470,1.0,0,1030,440,1984,2
3,2.5,1540,3.0,0,1390,150,1995,2
4,3.0,3130,1.5,0,1750,1380,1953,3
4,2.25,2110,2.0,0,2110,0,1972,3
3,1.75,1480,1.0,0,1480,0,1975,2
2,1.75,1990,1.0,0,1090,900,1952,2
2,1.0,1060,1.0,0,820,240,1981,1
2,1.0,1190,1.0,0,1190,0,1910,1
3,1.0,1100,1.0,0,1100,0,1961,1
3,1.5,1180,1.0,0,1180,0,1968,1
3,1.0,960,1.0,0,960,0,1967,1
3,1.0,1230,1.0,0,1230,0,1967,1
3,1.0,1390,1.0,0,1390,0,1954,1
3,1.75,1140,2.0,0,1140,0,2014,1
2,1.0,1500,1.0,0,1190,310,1926,1
4,2.25,1995,2.0,0,1995,0,1981,1
3,1.0,1560,1.0,0,910,650,1948,1
4,2.0,1700,1.0,0,850,850,1955,1
3,1.75,1940,1.5,0,1940,0,1918,1
3,1.5,1640,2.0,0,1640,0,1908,1
3,2.5,1520,2.0,0,1520,0,2004,1
4,3.0,2200,1.0,0,2200,0,1960,1
4,2.5,2090,2.0,0,2090,0,2007,2
3,1.0,930,1.5,0,930,0,1919,2
3,1.75,2220,1.0,0,1270,950,1950,2
3,1.0,1120,1.0,0,1120,0,1969,2
3,2.0,2250,1.5,0,2250,0,1998,2
2,1.5,800,1.0,0,800,0,1951,2
3,2.5,1450,2.0,0,1450,0,2004,2
3,2.5,2370,2.0,0,2370,0,2014,2
3,1.5,1800,2.0,0,1800,0,1931,2
4,1.75,1590,2.0,0,1590,0,1960,2
2,1.5,1260,2.0,0,1260,0,2001,2
3,2.5,1601,3.0,0,1536,65,2007,2
2,1.0,1190,1.0,0,1190,0,1981,2
3,2.5,1920,2.0,0,1920,0,1993,2
2,1.0,1290,1.0,0,1290,0,1906,2
3,2.25,1450,2.0,0,1450,0,1989,2
3,2.25,1620,3.0,0,1540,80,2009,2
3,1.75,2220,1.0,0,2220,0,1967,2
3,2.0,1490,2.0,0,1490,0,1948,2
5,1.75,1650,1.5,0,1650,0,1902,2
2,2.0,1240,2.0,0,1240,0,1985,2
3,2.5,1990,2.0,0,1990,0,1993,2
3,1.75,1480,1.0,0,1480,0,1971,2
3,1.5,1740,1.5,0,1640,100,1920,2
5,2.5,2510,1.0,0,1490,1020,1977,2
3,2.25,1680,1.0,0,1130,550,1959,2
4,2.5,2286,2.0,0,2286,0,2002,2
3,1.75,1880,1.0,0,1880,0,1984,2
3,1.0,1890,1.5,0,1390,500,1901,2
3,2.5,1910,2.0,0,1910,0,2014,2
3,2.5,1720,2.0,0,1720,0,2011,3
3,2.5,3030,2.0,0,3030,0,2009,3
3,2.5,1420,3.0,0,1420,0,2014,3
6,3.5,3000,1.0,0,1500,1500,1979,3
3,1.75,1320,1.0,0,870,450,1918,3
3,2.25,2590,2.0,3,2590,0,1984,3
3,2.5,2040,2.0,0,2040,0,1987,3
4,1.0,1660,1.5,0,1260,400,1930,3
2,2.0,1580,1.0,0,790,790,1910,3
3,2.0,1640,1.0,3,820,820,1924,3
4,2.5,2400,2.0,0,2400,0,1990,3
3,2.0,1860,2.0,0,1860,0,1908,3
3,2.75,1830,2.0,0,1690,140,2011,3
4,2.0,2530,1.5,0,1910,620,1910,3
4,2.5,2690,2.0,0,2690,0,1985,3
5,2.0,2800,1.0,0,1400,1400,1963,3
6,3.0,4050,2.0,0,2620,1430,1970,3
5,2.5,2860,2.0,0,2860,0,1958,3
4,2.75,2330,2.0,0,2330,0,2005,3
3,3.25,2030,2.0,0,2030,0,1980,3
4,2.25,2350,2.0,0,2350,0,1977,4
4,2.0,2600,1.0,2,1400,1200,1953,4
3,2.75,2760,1.0,0,1690,1070,1967,4
5,2.75,3595,2.0,0,3595,0,2014,4
4,3.25,3990,2.0,0,3990,0,2004,4
4,3.0,3040,1.5,0,2680,360,1923,4
3,2.5,3540,2.0,0,3540,0,1989,4
3,2.5,3870,2.0,3,3870,0,1997,4
4,3.0,5430,2.0,0,5430,0,1987,4
4,3.25,3770,2.0,0,2710,1060,1925,4
2,1.0,630,1.0,0,630,0,1930,1
3,1.0,1400,1.0,0,1400,0,1968,1
3,1.0,1350,1.5,0,1350,0,1942,1
1,1.0,850,1.0,0,850,0,1906,1
3,1.0,1040,1.0,0,800,240,1958,1
3,1.0,910,1.0,0,910,0,1968,1
3,1.0,1320,1.5,0,1320,0,1912,1
3,1.0,1180,1.0,0,1180,0,1967,1
3,2.0,960,1.0,0,960,0,1949,1
3,1.0,1070,1.0,0,1070,0,1949,1
3,1.75,1200,1.0,0,1200,0,1968,1
2,1.0,770,1.0,0,770,0,1948,1
3,1.5,1460,1.0,0,1460,0,1966,1
2,1.0,1020,1.0,0,1020,0,1939,1
5,2.5,2340,1.0,0,1670,670,1967,1
3,2.5,1600,2.0,0,1600,0,1992,1
2,1.5,1090,2.0,0,1090,0,1982,1
3,1.75,1140,1.0,0,1140,0,1983,1
4,2.5,2530,2.0,0,2530,0,1993,1
3,1.75,1550,1.0,0,1050,500,1976,1
3,1.0,1400,1.5,0,1400,0,1944,1
3,2.5,2538,2.0,0,2538,0,2013,1
3,1.5,1520,1.0,0,1520,0,1959,1
3,2.25,1910,2.0,0,1910,0,2009,1
4,2.5,2200,2.0,0,2200,0,1998,2
3,1.0,1150,1.0,0,1150,0,1960,2
4,2.5,1920,2.0,2,1920,0,1994,2
2,1.0,1080,1.0,0,720,360,1919,2
3,3.25,1450,2.0,0,1180,270,2013,2
2,1.0,810,1.0,0,810,0,1941,2
2,1.0,800,1.0,0,800,0,1953,2
3,1.0,1060,1.0,0,1060,0,1968,2
3,2.25,2220,1.0,0,1330,890,1993,2
3,2.25,2120,1.0,0,1720,400,1979,2
4,2.5,2250,2.0,0,2250,0,2014,2
3,2.25,2760,1.0,0,2760,0,1969,2
3,2.25,2120,1.0,0,2120,0,1997,2
4,2.75,3000,2.0,0,3000,0,2005,2
2,1.75,1210,2.0,0,1210,0,2014,2
5,3.0,1810,2.0,0,1810,0,1998,2
4,1.75,2100,1.0,0,1030,1070,1964,2
3,1.75,1570,2.0,0,1570,0,1982,2
3,1.0,1650,1.0,0,980,670,1954,2
3,1.75,1660,1.0,0,1130,530,1976,2
3,2.5,2860,2.0,0,2860,0,1990,2
4,2.5,1984,1.0,0,1564,420,1962,2
4,2.5,2620,2.0,0,2620,0,1991,2
3,2.25,2090,1.0,0,2090,0,1961,2
3,1.75,1180,1.0,0,1180,0,1967,2
3,1.75,1880,1.0,0,940,940,1945,2
4,1.75,1360,1.5,0,1360,0,1928,2
4,2.5,2560,2.0,0,2560,0,2006,2
4,2.25,2060,1.0,0,1220,840,1963,2
3,2.0,1320,1.5,0,1320,0,1920,2
4,1.75,1920,2.0,0,1920,0,1970,2
3,2.0,1550,1.0,0,830,720,1942,2
4,2.75,2230,1.0,0,1320,910,1998,2
4,2.5,2150,2.0,0,2150,0,2010,2
2,2.0,1270,3.0,0,1270,0,2000,2
4,2.25,2570,2.0,0,2570,0,1980,2
4,2.5,2680,2.0,0,2680,0,2013,2
4,3.5,3440,2.0,0,3440,0,2002,2
4,2.5,1910,1.0,0,1910,0,1921,2
3,1.5,1830,1.0,0,1830,0,1962,2
4,2.75,2530,2.0,0,2530,0,1997,2
3,1.0,1340,1.0,0,1340,0,1955,2
2,1.0,1060,1.0,0,860,200,1924,2
4,2.25,1900,1.0,0,1370,530,1977,2
3,2.5,1810,2.0,0,1810,0,1992,3
2,1.5,1920,1.0,0,960,960,1912,3
5,2.5,2820,1.0,0,1550,1270,1968,3
2,2.5,1785,2.0,0,1595,190,1975,3
3,1.75,1070,1.0,0,1070,0,1966,3
3,3.5,2490,2.0,0,1720,770,2005,3
3,2.25,1820,2.0,0,1820,0,1984,3
4,2.25,1950,1.0,0,1330,620,1968,3
4,1.75,2790,1.0,2,1450,1340,1956,3
4,2.5,2130,1.0,0,1490,640,1980,3
3,2.25,1940,1.0,0,1520,420,1987,3
4,2.5,2630,2.0,0,2630,0,1999,3
2,2.0,1570,1.0,0,1570,0,2006,3
3,2.0,2560,1.0,0,1330,1230,1987,3
3,2.25,1900,1.5,0,1440,460,1969,3
4,2.5,2250,2.0,0,2250,0,1991,3
3,1.75,2050,1.0,0,2050,0,1973,3
2,2.5,2290,2.0,0,2290,0,2005,3
4,2.5,2850,2.0,0,2850,0,1987,3
4,3.0,3720,1.0,0,1880,1840,2003,3
3,2.75,2830,2.0,0,2830,0,2012,3
4,2.5,2610,2.0,0,2610,0,2006,3
4,2.5,3220,2.0,0,3220,0,1991,3
5,2.75,2510,1.0,1,1600,910,1975,3
4,3.0,3580,2.5,0,2370,1210,1991,4
4,2.25,2410,2.0,0,2410,0,1965,4
4,2.75,3090,2.0,0,3090,0,2010,4
4,4.0,3010,2.0,0,3010,0,2004,4
2,2.5,2560,2.0,0,1690,870,1901,4
4,3.5,5270,2.0,0,3440,1830,2004,4
3,2.5,3420,1.0,0,1750,1670,1987,4
2,2.75,2700,1.0,0,2700,0,2007,4
4,3.5,3370,2.0,0,2750,620,2007,4
3,2.75,3176,2.0,3,2726,450,1985,4
3,2.5,3180,2.0,0,3180,0,1978,4
3,2.5,3480,1.0,0,1750,1730,1941,4
5,2.75,3500,2.0,2,2950,550,1927,4
4,2.5,3130,2.0,0,3130,0,2013,4
4,3.75,4740,2.0,0,4740,0,1991,4
2,2.0,2360,1.5,0,2360,0,1997,4
4,2.5,3180,1.0,0,2390,790,1978,4
3,2.25,2790,1.0,3,2790,0,2006,4
3,2.5,3830,2.0,0,3830,0,1991,4
4,3.5,3960,2.0,0,2850,1110,2006,4
4,3.5,3150,2.0,0,3150,0,2014,4
4,5.25,6500,2.0,0,5180,1320,2001,4
3,1.0,960,1.0,0,960,0,1970,1
3,0.75,490,1.5,0,490,0,1959,1
4,1.0,1600,1.0,0,1600,0,1966,1
2,1.0,840,1.0,0,840,0,1952,1
3,2.5,1610,2.0,0,1610,0,1994,1
3,1.75,1770,1.0,0,1770,0,1959,1
4,1.5,1860,1.5,0,1860,0,1920,1
3,1.0,1200,1.0,0,1200,0,1967,1
3,1.0,990,1.0,0,990,0,1943,1
4,2.25,2010,1.0,0,1170,840,1979,1
3,1.5,1940,1.0,0,1140,800,1969,1
2,1.75,1460,1.0,0,1460,0,1987,1
3,1.0,990,1.0,0,990,0,1960,1
4,1.75,1120,1.0,0,1120,0,1966,1
4,2.5,1660,1.0,0,1660,0,1978,1
4,2.0,2030,2.0,0,2030,0,1944,1
3,1.0,1200,1.0,0,1200,0,1954,1
4,1.75,1880,1.0,0,1130,750,1960,1
3,1.5,1500,1.0,0,1500,0,1957,1
5,1.5,1730,1.0,0,1010,720,1962,1
3,1.5,1950,1.0,0,1950,0,1959,1
2,1.0,800,1.0,0,800,0,1953,1
3,2.5,1460,2.0,0,1460,0,2000,1
4,1.75,1820,1.0,0,1190,630,1926,2
3,1.5,1800,1.0,0,1800,0,1966,2
3,1.0,1450,1.0,0,1010,440,1969,2
3,1.75,1510,1.0,0,1510,0,1954,2
3,2.25,1980,1.0,0,1300,680,1963,2
3,1.5,1460,1.0,0,1460,0,1952,2
3,1.0,1370,2.0,0,1370,0,1930,2
3,1.0,1600,1.0,0,1600,0,1958,2
3,2.5,1590,2.0,0,1590,0,2000,2
3,1.5,1550,1.0,0,1080,470,1978,2
3,2.25,1390,3.0,0,1390,0,2007,2
3,2.5,1530,2.0,0,1530,0,1986,2
4,2.75,1970,1.0,0,1970,0,1961,2
2,1.0,930,1.0,0,930,0,1940,2
5,2.75,1970,1.0,0,1320,650,1986,2
3,2.0,1760,1.0,0,1760,0,1967,2
5,3.25,3320,2.0,0,2480,840,1999,2
3,1.75,1660,1.0,0,830,830,1980,2
4,3.5,3360,2.0,0,2450,910,1990,2
4,1.5,1840,1.5,0,1840,0,1950,2
3,2.5,3010,2.0,0,3010,0,2009,2
2,1.0,1320,1.0,0,1020,300,1939,2
4,2.5,2550,2.0,0,2550,0,2009,2
3,1.5,1270,3.0,0,1270,0,2007,2
3,2.25,1920,2.0,0,1920,0,1989,2
4,2.5,1980,2.0,0,1980,0,1974,2
4,2.5,2100,1.0,0,1240,860,1976,2
4,2.25,2380,2.0,0,1530,850,1979,2
5,2.75,2550,1.0,0,1390,1160,1967,2
4,2.5,3560,2.0,0,3560,0,1988,2
4,2.5,2540,2.0,0,2540,0,2005,2
3,2.0,2660,1.0,0,2660,0,1964,2
2,1.75,1350,1.0,0,1350,0,2008,2
3,1.75,2140,1.0,0,1490,650,1950,3
4,2.5,3670,2.0,0,3670,0,2005,3
4,2.75,2910,1.0,0,1640,1270,1985,3
4,1.75,1710,1.0,0,1710,0,1955,3
3,2.5,1790,2.0,0,1790,0,2010,3
3,2.5,1460,2.0,0,1460,0,1983,3
3,2.5,2760,2.0,0,2760,0,2002,3
4,1.75,2150,1.0,0,1110,1040,1966,3
3,2.0,1970,2.0,3,1270,700,1929,3
4,1.0,1440,1.5,0,1440,0,1924,3
3,2.5,1960,2.0,0,1960,0,2002,3
4,2.5,2570,2.0,0,2570,0,1990,3
3,2.5,2500,2.0,0,2500,0,1990,3
3,3.25,2220,1.5,0,1770,450,1929,3
6,3.75,4000,2.0,2,3080,920,2004,3
3,1.75,1850,1.0,0,1020,830,1909,3
3,2.5,2600,2.0,1,2600,0,1998,3
3,2.5,2650,1.0,0,1680,970,1975,3
4,2.5,2720,2.0,0,2720,0,1989,3
4,3.25,3730,2.0,0,2760,970,2013,3
7,2.5,2580,1.0,0,1880,700,1901,3
3,3.25,1830,3.0,0,1830,0,2014,3
3,2.5,2630,2.0,0,2630,0,2001,3
3,2.0,2250,1.0,0,1500,750,1964,3
4,1.0,1600,1.5,0,1600,0,1946,3
3,1.75,1710,1.0,0,1710,0,1986,3
4,2.5,3080,2.0,0,3080,0,1997,3
4,2.75,3510,2.0,0,3510,0,2014,3
4,2.5,2510,2.0,0,2510,0,2002,3
4,2.75,2100,1.5,0,1780,320,1928,3
3,2.0,1780,1.0,0,980,800,1925,3
4,2.75,3710,2.0,0,3710,0,1999,3
4,3.5,3650,2.0,0,2550,1100,1996,3
4,2.5,3350,2.0,0,3350,0,1985,4
4,3.25,4280,2.0,0,3050,1230,2002,4
2,2.25,2290,1.0,0,2290,0,2007,4
3,1.75,2320,2.0,0,2320,0,1935,4
4,2.5,3360,2.0,0,3360,0,1997,4
2,2.5,2150,1.0,0,2150,0,2010,4
3,2.75,2820,2.0,0,2820,0,2008,4
4,2.75,2700,2.0,0,2100,600,1910,4
4,2.75,2910,1.0,0,2210,700,1957,4
4,2.5,3020,2.0,0,3020,0,2004,4
4,1.75,2100,1.0,0,1340,760,1975,4
4,2.25,3300,3.0,0,3300,0,2014,4
4,1.75,2000,1.0,4,1000,1000,1958,4
3,2.0,2783,2.0,0,2783,0,1910,4
5,4.5,4030,2.0,0,4030,0,2000,4
4,3.5,4440,2.0,0,4440,0,2003,4
4,3.75,4260,2.0,0,4260,0,2008,4
5,3.5,5430,2.0,2,4010,1420,2007,4
4,3.5,3550,1.0,2,2260,1290,1999,4
6,4.5,4230,2.0,3,2360,1870,1916,4
5,5.25,4830,2.0,1,3930,900,1952,4
5,4.75,5780,2.0,0,4260,1520,2006,4
4,2.0,2090,1.0,0,1070,1020,1974,1
3,2.5,1490,2.0,0,1490,0,1990,1
3,1.75,1580,1.0,0,1180,400,1993,1
3,2.5,1530,2.0,0,1530,0,1991,1
3,2.25,1720,2.0,0,1720,0,1983,1
4,2.5,2800,2.0,0,2800,0,1993,2
4,1.0,1170,1.5,0,1170,0,1959,2
3,2.5,2110,2.0,0,2110,0,1989,2
4,2.5,2380,2.0,0,2380,0,2005,2
3,1.0,1470,1.0,0,1470,0,1953,2
4,2.5,2700,2.0,0,2700,0,1998,2
4,2.0,1560,1.0,0,1560,0,1968,2
4,1.75,1520,1.0,0,1520,0,1967,2
2,1.0,1240,1.0,0,1240,0,1962,3
2,2.0,2930,1.0,2,1680,1250,1980,3
4,2.75,2600,1.0,0,1580,1020,1976,3
4,2.0,1840,1.0,0,920,920,1942,3
3,2.0,2320,1.0,0,1510,810,1956,3
3,2.5,2700,2.0,0,1280,1420,2003,3
4,2.5,3340,2.0,2,3340,0,1999,4
2,1.75,1950,1.0,0,1010,940,1919,4
3,2.5,2820,2.0,0,2820,0,2004,4
6,2.75,2980,1.5,0,2480,500,1916,4
3,2.75,2220,2.0,0,1700,520,1914,4
4,3.5,3840,2.0,0,3840,0,1998,4
5,2.0,2310,1.5,0,2310,0,1966,4
4,2.5,3360,2.0,0,3360,0,1994,4
6,2.5,2640,2.0,0,1760,880,1922,4
5,4.25,6070,2.0,0,6070,0,1999,4
